STATE,SITE_NAME,ESA_CODE,MDF_CODE,ISAM_AVAIL_PRTS_MAX_20MBPS,ADDNL_AVAIL_PRTS_MAX_20MBPS,ADDNL_AVAIL_PRTS_MAX_8MBPS,TOTAL_AVAIL_PRTS
QLD,ACACIA RIDGE,AARE,AARE01,1580,0,0,1580
SA,BROOKLYN PARK,AASS,AASS01,166,0,274,440
VIC,APOLLO BAY,ABAY,ABAY01,204,121,0,325
NSW,AVOCA BEACH,ABCH,ABCH01,1216,283,811,2310
QLD,ALBANY CREEK,ABCK,ABCK01,344,0,0,344
NSW,ABERDEEN,ABDN,ABDN01,298,0,0,298
NSW,ABERMAIN,ABMN,ABMN01,70,1,0,71
QLD,ALBION,ABON,ABON01,1,0,407,408
QLD,ASCOT,ACOT,ACOT01,360,0,0,360
NSW,ADAMINABY,ADAM,ADAM01,334,0,0,334
NSW,ARMIDALE,ADLE,ADLE01,299,0,0,299
NSW,ADELONG,ADLG,ADLG01,195,0,0,195
NT,ADELAIDE RIVER,AERR,AERC01,0,0,6,6
VIC,ARCHIES CREEK,AESK,AESK01,277,0,0,277
SA,ANGLE VALE,AEVE,AEVE01,161,0,0,161
QLD,ABERGOWRIE,AGOW,AGOW01,0,28,0,28
QLD,ASHGROVE,AGVE,AGVE01,47,0,0,47
QLD,AGNES WATER,AGWS,AGWS01,158,0,0,158
NT,PLENTY AMPILATWATJA,PLNY,AIJE01,72,0,0,72
QLD,AIRLIE BEACH,AIRL,AIRL01,639,0,845,1484
QLD,AIRVILLE,AIRV,AIRV01,0,0,0,0
VIC,ANAKIE,AKIE,AKIE01,220,0,0,220
NSW,ALBURY,ALBY,ALBY01,2530,0,1479,4009
NT,DAVENPORT - ALI CURUNG,DAVE,ALCG01,94,0,0,94
QLD,ALICE RIVER,ALCR,ALCR01,283,0,291,574
SA,ALDINGA,ALDA,ALDA01,45,0,0,45
VIC,AIREYS INLET,ALET,ALET01,51,0,0,51
VIC,APSLEY,ALEY,ALEY01,168,0,0,168
VIC,ALFREDTON,ALFN,ALFN01,310,0,307,617
QLD,ALLIGATOR CREEK,ALGR,ALGR01,289,0,0,289
QLD,ALLINGHAM,ALHM,ALHM01,0,272,0,272
QLD,ALLORA,ALLO,ALLO01,104,0,0,104
VIC,ALLANSFORD,ALND,ALND01,219,0,0,219
WA,ALBANY NORTH,ALNY,ALNO01,24,0,42,66
WA,ALBANY,ALNY,ALNY01,1086,0,179,1265
QLD,ALPHA,ALPH,ALPH01,62,0,0,62
NSW,ALBION PARK,ALPK,ALPK01,3768,0,0,3768
NT,ALICE SPRINGS,ALSS,ALSS01,2885,0,5,2890
NSW,ALSTONVILLE,ALST,ALST01,1,0,666,667
VIC,ALTONA,ALTA,ALTA01,6,0,205,211
QLD,ALTON DOWNS,ALTO,ALTO01,147,0,0,147
QLD,ALEXANDRA HILLS,ALXH,ALXH01,682,0,4,686
QLD,AMAMOOR,AMAM,AMAM01,197,0,0,197
NT,PETERMANN AMATA,PETN,AMAO01,26,0,0,26
QLD,AMBERLEY,AMBE,AMBE01,3,0,0,3
WA,AMBERGATE,AMGT,AMGT01,0,0,0,0
QLD,AMITY POINT,AMIT,AMIT01,42,0,0,42
SA,AMERICAN RIVER,AMRV,AMRV01,0,112,0,112
NSW,ANEMBO,ANBO,ANBO01,0,0,0,0
VIC,AVENEL,ANEL,ANEL01,0,0,0,0
SA,ANGASTON,ANGN,ANGN01,369,0,0,369
NSW,ANNA BAY,ANNA,ANNA01,542,0,0,542
QLD,GULLIVER ANNANDALE OP MDF,GULL,ANXL01,151,0,0,151
VIC,ARDMONA,AONA,AONA01,303,0,0,303
QLD,ASPLEY,APLY,APLY01,1185,0,0,1185
NSW,APPIN EXCHANGE,APPN,APPN01,229,235,0,464
WA,APPLECROSS,APPX,APPX01,313,0,0,313
NSW,ARALUEN,ARAL,ARAL01,61,0,0,61
QLD,ARAMAC,ARAM,ARAM01,0,0,0,0
VIC,ARARAT,ARAT,ARAT01,233,0,328,561
VIC,ARTHURS CREEK,ARCK,ARCK01,119,0,0,119
NSW,ARDING,ARDG,ARDG01,0,0,0,0
NSW,ARNDELL PARK,BLAC,ARDK01,668,0,0,668
NSW,ARDLETHAN,ARDL,ARDL01,0,42,49,91
SA,ARDROSSAN,ARDN,ARDN01,289,27,0,316
WA,ARMADALE,ARMD,ARMD01,1502,0,2159,3661
NSW,ARIAH PARK,ARPK,ARPK01,0,68,0,68
NSW,ARUMPO,ARPO,ARPO01,0,0,23,23
QLD,ARUNDEL,ARUN,ARUN01,71,0,16,87
QLD,ASCOT FACTORY,ASCO,ASCO01,0,0,0,0
VIC,ASCOT,ASCT,ASCT01,2,0,1940,1942
VIC,ANGLESEA,ASEA,ASEA01,247,252,481,980
NSW,ASHFORD,ASHD,ASHD01,334,0,0,334
NSW,ASHFIELD,ASHF,ASHF01,698,0,0,698
QLD,ASHMORE,ASHM,ASHM01,1608,0,0,1608
NSW,ASHLEY,ASLY,ASLY01,0,14,0,14
WA,ASCOT,ASOT,ASOT01,471,0,1,472
NT,YULARA AYERS ROCK,YULA,ASRK01,56,0,0,56
QLD,ATHERTON,ATHE,ATHE01,2059,0,0,2059
QLD,ARATULA,ATLA,ATLA01,111,0,0,111
WA,ASCOT PIA EXCHANGE,ASOT,ATQK01,167,0,0,167
WA,ATTADALE,ATTA,ATTA01,654,0,355,1009
NSW,ATTUNGA,ATUN,ATUN01,0,0,0,0
SA,AUBURN,AUBN,AUBN01,263,0,0,263
QLD,AUGATHELLA,AUGA,AUGA01,115,0,0,115
WA,AUGUSTA,AUGU,AUGU01,0,170,59,229
NT,PLENTY ALPARRA,PLNY,AUJE01,82,0,0,82
QLD,AURUKUN,AURN,AURN01,90,0,0,90
WA,AUSTRALIND,AUSD,AUSD01,1181,0,0,1181
NSW,AUSTRAL,AUST,AUST01,343,0,10,353
NSW,AVALON BEACH,AVAL,AVAL01,1762,72,2240,4074
TAS,AVOCA,AVCA,AVCA01,0,23,0,23
VIC,ALVIE,AVIE,AVIE01,0,71,0,71
VIC,AVOCA,AVOA,AVOA01,28,0,0,28
QLD,AVOCA,AVOC,AVOC01,237,0,26,263
VIC,ALEXANDRA,AXDA,AXDA01,126,0,0,126
VIC,AXEDALE,AXEE,AXEE01,292,0,0,292
VIC,AXE CREEK,AXEK,AXEK01,137,0,0,137
NT,ALYANGULA,AYLB,AYLB01,103,0,0,103
QLD,AYR,AYRR,AYRR01,1768,0,0,1768
TAS,BAGDAD,BAAD,BAAD01,190,0,0,190
NSW,BARRABA,BABA,BABA01,217,0,0,217
QLD,BABINDA,BABI,BABI01,206,0,0,206
VIC,BACCHUS MARSH,BACC,BACC01,0,0,0,0
VIC,BARANDUDA,BADA,BADA01,284,0,0,284
TAS,BADEN,BAEN,BAEN01,128,0,0,128
QLD,BAFFLE CREEK,BAFF,BAFF01,185,0,0,185
NSW,BAROOGA,BAGA,BAGA01,49,0,0,49
VIC,BAIRNSDALE,BAIR,BAIR01,438,0,765,1203
QLD,BAJOOL,BAJO,BAJO01,154,0,0,154
NSW,BANKSTOWN AIRPORT,BANK,BAKA01,188,0,0,188
NSW,BALLALABA,BALA,BALA01,0,0,0,0
VIC,BALACLAVA,BALC,BALC01,2,0,141,143
WA,BALDIVIS,BALD,BALD01,245,0,123,368
NSW,BALGOWLAH,BALG,BALG01,906,0,0,906
NSW,BALMAIN,BALM,BALM01,1230,0,0,1230
VIC,BALLAN,BALN,BALN01,117,0,0,117
VIC,BALMORAL,BALO,BALO01,0,0,0,0
WA,BALINGUP,BALP,BALP01,310,0,0,310
VIC,BAMAWM,BAMA,BAMA01,112,0,0,112
NSW,BANGALOW,BANG,BANG01,84,0,0,84
NSW,BANKSTOWN,BANK,BANK01,481,0,0,481
TAS,BARRINGTON,BAON,BAON01,140,0,0,140
QLD,BRISBANE AIRPORT,BAPT,BAPT01,0,74,153,227
QLD,BARCALDINE,BARC,BARC01,160,0,0,160
QLD,BARGARA,BARG,BARG01,0,0,286,286
VIC,BARMAH,BARM,BARM01,146,0,0,146
VIC,BARONGAROOK,BARO,BARO01,0,0,0,0
VIC,BASS,BASS,BASS01,134,0,0,134
WA,BATEMAN,BATA,BATA01,1139,0,0,1139
NSW,BATEMANS BAY,BATE,BATE01,559,59,458,1076
NSW,BATHURST,BATH,BATH01,1420,0,775,2195
NSW,BATLOW,BATL,BATL01,11,0,0,11
VIC,BATMAN,BATM,BATM01,371,0,371,742
NSW,BAULKHAM HILLS,BAUL,BAUL01,64,0,0,64
VIC,BAYSWATER NORTH,BAWN,BAWN01,111,0,0,111
VIC,BAW BAW,BAWW,BAWW01,0,0,20,20
VIC,BAXTER,BAXR,BAXR01,35,0,843,878
VIC,BAYLES,BAYL,BAYL01,212,0,0,212
VIC,BAYSWATER,BAYR,BAYR01,1095,0,0,1095
WA,BURNS BEACH,BBCH,BBCH01,15,0,182,197
QLD,BUNDABERG,BBEG,BBEG01,5039,0,2693,7732
QLD,BELLS BRIDGE,BBGE,BBGE01,297,0,0,297
WA,BULLSBROOK EAST,BBKE,BBKE01,114,0,0,114
NSW,BELBORA,BBOR,BBOR01,0,0,0,0
NSW,BUNDABURRAH,BBRH,BBRH01,0,0,0,0
VIC,BANNOCKBURN,BBRN,BBRN01,784,0,0,784
WA,BUNBURY,BBRY,BBRY01,1782,0,1047,2829
NSW,BILBUL,BBUL,BBUL01,139,0,0,139
WA,BECHER,BCHE,BCHE01,2,0,0,2
NSW,BURCHER,BCHR,BCHR01,0,0,0,0
WA,BEECHBORO,BCHS,BCHS01,919,0,0,919
QLD,BUNDAMBA,BDBA,BDBA01,597,0,400,997
NSW,BERRIDALE,BDLE,BDLE01,225,0,0,225
NSW,BENDALONG,BDLG,BDLG01,127,0,0,127
NSW,BARADINE,BDNE,BDNE01,0,0,0,0
NSW,BUNDARRA,BDRA,BDRA01,142,0,0,142
NSW,BALLADORAN,BDRN,BDRN01,0,0,0,0
QLD,BEAUDESERT,BDST,BDST01,1091,0,69,1160
SA,BORDERTOWN,BDTN,BDTN01,511,0,0,511
SA,BIRDWOOD,BDWD,BDWD01,1,0,0,1
VIC,BROADMEADOWS,BDWS,BDWS01,3,0,553,556
VIC,BEEAC,BEAC,BEAC01,0,107,0,107
VIC,BEAUMARIS,BEAU,BEAU01,138,0,133,271
QLD,BENARABY,BEBY,BEBY01,185,0,0,185
NSW,BEECHWOOD,BECH,BECH01,0,182,0,182
VIC,BEACONSFIELD UPPER,BECU,BECU01,0,0,0,0
NSW,BEDGEREBONG,BEDG,BEDG01,0,0,0,0
VIC,BONNIE DOON,BEDN,BEDN01,145,0,0,145
QLD,GEORGINA,GINA,BEDP01,184,0,0,184
QLD,BEENLEIGH,BEEL,BEEL01,2,0,533,535
QLD,BEERBURRUM,BEEM,BEEM01,53,0,0,53
NSW,BEGA,BEGA,BEGA01,247,0,423,670
TAS,BEACONSFIELD,BELD,BELD01,404,0,0,404
NSW,BELFORD,BELF,BELF01,52,0,0,52
VIC,BELGRAVE,BELG,BELG01,131,0,0,131
QLD,BELLI,BELI,BELI01,81,0,0,81
VIC,BELMONT,BELM,BELM01,482,0,1951,2433
WA,ELLENBROOK OP MDF,ELBK,BELS01,3,0,113,116
NSW,BELMONT,BELT,BELT01,281,0,825,1106
NSW,BELUBULA,BELU,BELU01,0,0,0,0
NSW,BELLANGRY,BELY,BELY01,61,0,48,109
NSW,BERRIMA,BEMA,BEMA01,186,0,0,186
NSW,BEMBOKA,BEMB,BEMB01,148,0,0,148
VIC,BENA,BENA,BENA01,154,0,0,154
VIC,BENDIGO WILLIAMSON STREET,BEND,BENC01,2291,0,376,2667
VIC,BENDIGO SHORT STREET,BEND,BEND01,1233,0,2143,3376
NSW,BENI,BENI,BENI01,0,0,0,0
NSW,BENDEMEER,BENR,BENR01,165,0,0,165
VIC,BENTLEIGH,BENT,BENT01,18,0,0,18
SA,BERRI,BERI,BERI01,84,0,0,84
VIC,BERRYS CREEK,BERK,BERK01,139,0,0,139
NSW,BEROWRA,BERO,BERO01,554,0,0,554
NSW,BERMAGUI SOUTH,BERS,BERS01,101,0,0,101
NSW,BERRY,BERY,BERY01,91,0,0,91
VIC,BEULAH,BEUL,BEUL01,0,0,0,0
VIC,BEVERFORD,BEVD,BEVD01,118,0,0,118
TAS,BELLERIVE,BEVE,BEVE01,1417,0,359,1776
VIC,BERWICK,BEWK,BEWK01,1301,0,709,2010
NSW,BEXHILL,BEXL,BEXL01,191,0,0,191
VIC,BEAUFORT,BFOT,BFOT01,180,0,0,180
WA,ASCOT DA057 BELMONT FORUM,ASOT,BFPB01,359,17,52,428
NSW,BERRIGAN,BGAN,BGAN01,152,0,0,152
TAS,BINALONG BAY,BGBY,BGBY01,173,0,0,173
QLD,BUNGUNDARRA,BGDA,BGDA01,76,0,0,76
TAS,BRIGHTON,BGHN,BGHN01,644,0,0,644
VIC,BRIGHT,BGHT,BGHT01,0,0,161,161
VIC,BRIGHTON,BGON,BGON01,84,0,2070,2154
SA,BANGOR,BGOR,BGOR01,0,0,0,0
NSW,BUNGENDORE,BGRE,BGRE01,407,0,0,407
WA,BRIDGETOWN,BGTO,BGTO01,506,0,218,724
NSW,BARHAM,BHAM,BHAM01,79,0,0,79
QLD,BURNETT HEADS,BHDS,BHDS01,200,0,0,200
VIC,BETHANGA,BHGA,BHGA01,279,0,0,279
NSW,BRUSHGROVE,BHGE,BHGE01,135,0,0,135
QLD,BEACHMERE,BHME,BHME01,661,0,0,661
QLD,BEECHMONT,BHMT,BHMT01,149,0,0,149
SA,BEACHPORT,BHPT,BHPT01,111,0,0,111
NSW,BROCKLEHURST,BHST,BHST01,0,0,25,25
WA,CANNINGTON OP MDF BHUC 01,CANN,BHUC01,524,0,0,524
WA,BALDIVIS,BALD,BHVX01,238,0,0,238
QLD,BURLEIGH HDS BURL WATERS,BURL,BHWR01,0,0,264,264
QLD,BIDDADDABA,BIDD,BIDD01,0,13,0,13
QLD,BIGGENDEN,BIGN,BIGN01,238,0,0,238
NSW,BILAMBIL HEIGHTS,BILH,BILH01,62,0,192,254
QLD,BILOELA,BILO,BILO01,214,0,0,214
NSW,BINGARA,BINA,BINA01,67,0,0,67
WA,BINDOON,BIND,BIND01,78,0,0,78
TAS,BISHOPSBOURNE,BINE,BINE01,294,0,0,294
TAS,BICHENO,BINO,BINO01,100,0,0,100
VIC,BIRREGURRA,BIRA,BIRA01,101,0,0,101
VIC,BIRCHIP,BIRP,BIRP01,297,0,0,297
NSW,BERRILEE,BIRR,BIRR01,12,0,0,12
VIC,BOOKAR,BKAR,BKAR01,0,0,0,0
WA,BAKERS HILL,BKHL,BKHL01,176,0,0,176
NSW,BRUNSWICK HEADS,BKHS,BKHS01,0,0,184,184
QLD,BROOKFIELD,BKID,BKID01,779,0,280,1059
VIC,BROOKLYN,BKLN,BKLN01,754,0,334,1088
NSW,BLACK MOUNTAIN,BKMT,BKMT01,0,46,0,46
NSW,BERKSHIRE PARK,BKPK,BKPK01,606,0,0,606
NT,PETERMANN BLACKSTONE,PETN,BKSE01,0,0,0,0
SA,BALAKLAVA,BKVA,BKVA01,298,0,0,298
SA,BLACKWOOD,BKWD,BKWD01,1898,0,12,1910
NSW,BLACKTOWN,BLAC,BLAC01,271,0,0,271
VIC,BLACKWOOD,BLAD,BLAD01,20,0,0,20
NSW,BLAKEHURST,BLAK,BLAK01,912,0,0,912
VIC,BLAIRGOWRIE,BLAR,BLAR01,381,0,238,619
NSW,BELLATA,BLAT,BLAT01,0,0,0,0
NSW,BLAXLANDS RIDGE,BLAX,BLAX01,75,55,0,130
NSW,BLAYNEY,BLAY,BLAY01,284,0,0,284
QLD,BARALABA,BLBA,BLBA01,0,0,0,0
VIC,BLACKBURN,BLBN,BLBN01,34,0,37,71
QLD,BLACKBUTT,BLBT,BLBT01,84,0,191,275
NSW,BURRELL CREEK,BLCK,BLCK01,112,0,0,112
QLD,BLACKALL,BLCM,BLCM01,175,0,0,175
ACT,BELCONNEN,BLCN,BLCN01,342,0,346,688
WA,BALCATTA,BLCT,BLCT01,0,6,4,10
WA,BOULDER,BLDF,BLDF01,0,0,0,0
QLD,BALLANDEAN,BLDN,BLDN01,0,0,0,0
NSW,BELLINGEN,BLGN,BLGN01,30,0,299,329
QLD,BALD HILLS,BLHS,BLHS01,623,0,0,623
QLD,BLI BLI,BLIB,BLIB01,327,0,138,465
WA,BALLAJURA,BLJA,BLJA01,185,0,2692,2877
WA,BALLAJURA EAST,BLJA,BLJF01,0,0,322,322
NSW,BLACKHEATH,BLKH,BLKH01,1201,0,134,1335
QLD,BELL,BLLL,BLLL01,0,0,0,0
NSW,BALLINA,BLNA,BLNA01,616,0,1,617
SA,BALHANNAH,BLNH,BLNH01,229,185,265,679
NSW,BILPIN,BLPN,BLPN01,184,0,0,184
WA,BLUFF POINT,BLPT,BLPT01,761,0,0,761
VIC,BOOLARRA,BLRA,BLRA01,290,0,0,290
SA,BOOLEROO CENTRE,BLRC,BLRC01,301,0,0,301
NSW,BOOLAROO,BLRO,BLRO01,2228,0,433,2661
QLD,BLACKWATER,BLTR,BLTR01,986,0,7,993
QLD,BLUEWATER,BLUE,BLUE01,118,0,0,118
QLD,BLUFF,BLUF,BLUF01,102,0,0,102
NSW,BERKELEY VALE,BLVE,BLVE01,351,0,0,351
WA,BALDIVIS SETTLERS HILL,BALD,BLVR02,61,0,0,61
SA,BLYTH,BLYH,BLYH01,147,0,0,147
SA,BARMERA,BMAA,BMAA01,496,0,0,496
QLD,BAMAGA,BMAG,BMAG01,0,8,0,8
SA,BARMERA WEST,BMAW,BMAW01,297,0,0,297
QLD,BULIMBA,BMBA,BMBA01,2344,0,0,2344
NSW,BERAMBING,BMBG,BMBG01,224,0,0,224
WA,BROOME WEST,BRMK,BMEW01,0,0,0,0
NT,BERRIMAH MENDIS ROAD,BRMH,BMHT01,0,55,0,55
NSW,BARMEDMAN,BMMN,BMMN01,0,0,0,0
VIC,BUNBARTHA,BNBA,BNBA01,0,0,0,0
NSW,BONALBO,BNBO,BNBO01,0,89,0,89
QLD,BUNDALL,BNDL,BNDL01,4,0,473,477
VIC,BARWON DOWNS,BNDS,BNDS01,123,0,0,123
NSW,BUNGONIA,BNGA,BNGA01,128,0,0,128
VIC,BARWON HEADS,BNHD,BNHD01,854,0,198,1052
NSW,BROKEN HILL,BNHL,BNHL01,175,0,0,175
VIC,BENALLA,BNLA,BNLA01,0,0,0,0
NSW,BINALONG,BNLG,BNLG01,0,0,0,0
QLD,BRINSMEAD,BNMD,BNMD01,1358,0,364,1722
QLD,BROWNS PLAINS,BNPS,BNPS01,956,0,0,956
NSW,BORENORE,BNRE,BNRE01,311,0,0,311
VIC,BALNARRING,BNRG,BNRG01,465,0,201,666
QLD,BOONOOROO,BNRO,BNRO01,134,0,0,134
NSW,BARRINGTON,BNTN,BNTN01,0,54,0,54
NSW,BONVILLE,BNVL,BNVL01,0,248,118,366
VIC,BARNAWARTHA,BNWA,BNWA01,195,0,0,195
NSW,BINNAWAY,BNWY,BNWY01,0,41,0,41
QLD,BOULDERCOMBE,BOCO,BOCO01,0,221,0,221
NSW,BODALLA,BODA,BODA01,196,0,0,196
WA,BODDINGTON,BODD,BODD01,149,0,0,149
NSW,BOGGABILLA,BOGG,BOGG01,0,67,0,67
NSW,BOGGABRI,BOGI,BOGI01,163,0,0,163
QLD,BOHLE,BOHL,BOHL01,632,73,332,1037
VIC,BOISDALE,BOIS,BOIS01,0,121,0,121
VIC,BOLINDA,BOLD,BOLD01,0,16,0,16
TAS,BOTHWELL,BOLL,BOLL01,127,0,0,127
NSW,BOMBALA,BOMB,BOMB01,22,0,0,22
VIC,BORONIA,BONA,BONA01,119,0,0,119
NSW,BONDI,BOND,BOND01,199,0,2141,2340
QLD,BOONAH,BOON,BOON01,252,0,0,252
VIC,BOORT,BOOR,BOOR01,296,0,0,296
QLD,BORALLON,BORA,BORA01,194,0,0,194
QLD,BOREEN POINT,BORE,BORE01,0,165,0,165
NT,BORROLOOLA,BORO,BORO01,116,0,0,116
VIC,BOOSEY,BOSE,BOSE01,146,0,0,146
NSW,BOTANY,BOTA,BOTA01,597,0,0,597
QLD,BOULIA,BOUL,BOUL01,51,0,0,51
TAS,BOAT HARBOUR,BOUR,BOUR01,271,0,0,271
NSW,BOOROWA,BOWA,BOWA01,0,0,0,0
WA,BOW BRIDGE,BOWB,BOWB01,0,0,0,0
NSW,BOWRAL,BOWL,BOWL01,2404,0,0,2404
NSW,BOWRAVILLE,BOWV,BOWV01,0,0,0,0
VIC,BOX HILL,BOXL,BOXL01,66,0,0,66
WA,BOYANUP,BOYA,BOYA01,87,0,0,87
WA,BOYUP BROOK,BOYB,BOYB01,223,0,0,223
QLD,BOYNE ISLAND,BOYN,BOYN01,513,0,0,513
QLD,BRANDON,BRAN,BRAN01,0,371,0,371
VIC,BALLARAT,BRAT,BRAT01,1260,0,2609,3869
QLD,BRAMSTON BEACH,BRBH,BRBH01,0,0,0,0
NSW,BURRUMBUTTOCK,BRBK,BRBK01,0,89,0,89
NSW,BYROCK,CTBA,BRCK01,0,0,0,0
NSW,BREDBO,BRED,BRED01,0,0,0,0
TAS,BRIDGEWATER,BRER,BRER01,1038,0,0,1038
NSW,BREWONGLE,BREW,BREW01,0,0,0,0
NSW,BARGO,BRGO,BRGO01,580,254,472,1306
NSW,BRINGELLY,BRGY,BRGY01,235,0,0,235
VIC,BRIAGOLONG,BRIA,BRIA01,228,0,0,228
VIC,BRIDGEWATER,BRID,BRID01,109,0,0,109
QLD,BRIBIE ISLAND,BRIL,BRIL01,1402,0,0,1402
SA,BRIGHTON,BRIH,BRIN01,321,0,0,321
WA,BRUNSWICK JUNCTION,BRJN,BRJN01,122,0,0,122
NSW,BOURKE,BRKE,BRKE01,94,0,0,94
WA,BROOKTON,BRKT,BRKT01,0,0,0,0
NSW,BALRANALD,BRLD,BRLD01,0,0,0,0
TAS,BRANXHOLM,BRLM,BRLM01,135,0,0,135
NSW,BARELLAN,BRLN,BRLN01,0,0,0,0
NT,BERRIMAH,BRMH,BRMH01,552,176,0,728
WA,BROOME,BRMK,BRMK01,5,0,266,271
WA,BREMER BAY,BRMY,BRMY01,0,113,0,113
NSW,BREWARRINA,BRNA,BRNA01,0,0,0,0
VIC,BROADFORD,BROA,BROA01,122,0,5,127
NSW,BROCKLESBY,BROC,BROC01,167,0,0,167
NSW,BROKE,BROK,BROK01,79,0,0,79
NSW,BROOKLYN,BROO,BROO01,153,0,0,153
NSW,BANORA POINT,BRPT,BRPT01,2605,0,388,2993
WA,BRUCE ROCK,BRRK,BRRK01,212,0,0,212
QLD,BOROREN,BRRN,BRRN01,0,86,0,86
TAS,BRIDPORT,BRRT,BRRT01,152,0,0,152
QLD,BRASSALL,BRSL,BRSL01,609,0,0,609
ACT,BARTON EXCHANGE,BRTN,BRTN01,295,0,578,873
VIC,BRUNSWICK,BRUK,BRUK01,181,0,0,181
VIC,BRUTHEN,BRUT,BRUT01,48,0,0,48
NSW,BRAIDWOOD,BRWD,BRWD01,83,0,0,83
NSW,BURRAWANG,BRWG,BRWG01,149,0,0,149
QLD,BEERWAH,BRWH,BRWH01,0,0,0,0
NSW,BRANXTON,BRXN,BRXN01,380,0,0,380
QLD,BANKSIA BEACH,BSBH,BSBH01,1103,829,355,2287
WA,BASSENDEAN,BSDN,BSDN01,1341,0,2116,3457
NSW,BROOMS HEAD,BSHD,BSHD01,117,0,0,117
NT,DARWIN WOOLNER ROAD,DRWN,BSHT01,1099,0,0,1099
NT,BERRIMAH COONAWARRA ROAD,BRMH,BSNT01,299,0,0,299
NSW,BETHUNGRA,BTGA,BTGA01,88,0,0,88
NT,BATCHELOR,BTLR,BTLR01,93,0,0,93
VIC,BANNERTON,BTON,BTON01,0,0,0,0
TAS,BATHURST,BTST,BTST01,1029,67,2695,3791
SA,BRENTWOOD,BTWD,BTWD01,0,0,0,0
NSW,BURNT YARDS,BTYD,BTYD01,0,0,0,0
QLD,BUCASIA,BUCA,BUCA01,646,0,230,876
QLD,BUDERIM,BUDE,BUDE01,2725,0,734,3459
NSW,BURRA CREEK,BUEK,BUEK01,0,0,0,0
VIC,BULLEEN,BUEN,BUEN01,181,0,663,844
TAS,BURNIE,BUIE,BUIE01,2344,657,0,3001
NSW,BULAHDELAH,BULA,BULA01,229,0,0,229
QLD,BULLYARD,BULD,BULD01,0,0,0,0
VIC,BULLENGAROOK,BULE,BULE01,192,0,0,192
NSW,BULGA,BULG,BULG01,0,104,0,104
VIC,BULLA,BULL,BULL01,64,0,0,64
VIC,BULLARTO,BULS,BULS01,119,0,0,119
VIC,BUNDOORA,BUNA,BUNA01,0,0,1,1
NSW,BUNDANOON,BUND,BUND01,506,0,369,875
VIC,BUNINYONG,BUNI,BUNI01,661,0,0,661
VIC,BUNYIP,BUNY,BUNY01,165,0,0,165
NSW,BUFF POINT,BUPT,BUPT01,2345,0,822,3167
SA,BURRA,BURA,BURA01,236,0,0,236
NSW,BURWOOD,BURD,BURD01,253,0,0,253
WA,BUREKUP,BURE,BURE01,301,0,0,301
QLD,BURKETOWN,BURK,BURK01,89,0,0,89
QLD,BURLEIGH HEADS,BURL,BURL01,392,0,2156,2548
QLD,BURRUM HEADS,BURM,BURM01,31,0,0,31
VIC,BURWOOD,BURW,BURW01,195,0,1,196
WA,BUSSELTON,BUSS,BUSS01,1517,0,503,2020
WA,BUSSELTON WEST,BUSS,BUSW01,360,0,0,360
QLD,BUTCHERS CREEK,BUTC,BUTC01,143,0,0,143
SA,BUTE,BUTE,BUTE01,153,0,0,153
WA,BEVERLEY,BVLY,BVLY01,234,0,0,234
QLD,BOWEN,BWEN,BWEN01,1026,0,344,1370
WA,BULWER,BWER,BWER01,346,0,197,543
NSW,BUNGWAHL,BWHL,BWHL01,269,0,0,269
VIC,BERWICK SOUTH,BWKS,BWKS01,2750,0,1,2751
NSW,BAWLEY POINT,BWLY,BWLY01,115,0,0,115
NSW,BOWNING,BWNG,BWNG01,0,115,0,115
VIC,BEECHWORTH,BWTH,BWTH01,36,0,0,36
NSW,BROADWATER,BWTR,BWTR01,186,0,0,186
NSW,BYABARRA,BYBA,BYBA01,0,0,0,0
NSW,BYRON BAY,BYBY,BYBY01,1,0,1,2
WA,BYFORD OLD BLD,BYFD,BYFD01,916,164,29,1109
NT,ROPER RIVER BARUNGA,ROPR,BYLI01,96,0,0,96
NT,BERRY SPRINGS,BYSP,BYSP01,0,0,0,0
NSW,BRAYTON,BYTN,BYTN01,0,0,18,18
VIC,BEAZLEYS BRIDGE,BZLY,BZLY01,0,0,0,0
QLD,CABARLAH,CABA,CABA01,157,0,0,157
QLD,CABOOLTURE,CABO,CABO01,4080,0,25,4105
VIC,CARRUM DOWNS,CADO,CADO01,74,0,96,170
NSW,CALGA,CAGA,CAGA01,0,16,0,16
TAS,CAMBRIDGE,CAGE,CAGE01,440,0,0,440
TAS,CAMPANIA,CAIA,CAIA01,0,0,0,0
NSW,CALLALA BAY,CALA,CALA01,693,0,0,693
QLD,CALIFORNIA CREEK,CALC,CALC01,261,0,191,452
NSW,CANOELANDS,CALD,CALD01,121,0,0,121
QLD,CALEN,CALE,CALE01,344,0,0,344
QLD,CALOUNDRA,CALO,CALO01,6,0,0,6
QLD,CALLIOPE,CALP,CALP01,206,0,0,206
QLD,CAMBOOYA,CAMA,CAMA01,0,192,0,192
WA,CARMEL,CAML,CAML01,47,0,0,47
QLD,CAMOOWEAL,CAMO,CAMO01,0,0,0,0
NSW,CAMPSIE,CAMP,CAMP01,0,0,459,459
NSW,CAMBEWARRA,CAMW,CAMW01,353,0,0,353
NSW,CANDELO,CAND,CAND01,264,0,0,264
VIC,COLERAINE,CANE,CANE01,236,0,0,236
NSW,CANYONLEIGH,CANL,CANL01,0,125,0,125
WA,CANNINGTON,CANN,CANN01,3733,0,5,3738
VIC,CANN RIVER,CANR,CANR01,125,0,0,125
NSW,CANOBOLAS,CANS,CANS01,327,0,0,327
QLD,CANUNGRA,CANU,CANU01,203,0,0,203
QLD,CANNON VALLEY,CANV,CANV01,53,0,0,53
NSW,CANOWINDRA,CANW,CANW01,286,0,0,286
QLD,CAPELLA,CAPE,CAPE01,0,0,0,0
WA,CAPEL,CAPL,CAPL01,170,0,0,170
VIC,CAPE PATERSON,CAPP,CAPP01,265,0,0,265
NSW,CARGO,CARG,CARG01,0,0,0,0
WA,CARNAMAH,CARH,CARH01,85,0,0,85
VIC,CARISBROOK,CARI,CARI01,21,0,0,21
NSW,CARLINGFORD,CARL,CARL01,155,0,0,155
NSW,CARRAMAR,CARR,CARR01,388,0,1387,1775
VIC,CASTLEMAINE,CASE,CASE01,1416,208,164,1788
QLD,CASHMERE,CASM,CASM01,108,0,0,108
NSW,CASTLE HILL,CAST,CAST01,2161,0,0,2161
QLD,CASSOWARY,CASY,CASY01,0,0,0,0
VIC,CATANI,CATA,CATA01,0,48,0,48
NSW,CATTAI,CATI,CATI01,0,0,0,0
VIC,CAULFIELD,CAUL,CAUL01,9,0,0,9
VIC,CAVENDISH,CAVE,CAVE01,147,0,0,147
NSW,COBAR,CBAR,CBAR01,316,0,428,744
QLD,COOMBABAH,CBBH,CBBH01,839,0,0,839
QLD,CAMPWIN BEACH,CBCH,CBCH01,0,520,0,520
QLD,CURRUMBIN CREEK,CBCK,CBCK01,135,0,0,135
NSW,COONAMBLE,CBLE,CBLE01,0,0,409,409
WA,CUBALLING,CBLG,CBLG01,0,0,0,0
NSW,CONDOBOLIN,CBLN,CBLN01,347,0,309,656
VIC,CRANBOURNE,CBNE,CBNE01,2612,0,0,2612
VIC,CLYDEBANK,CBNK,CBNK01,0,0,0,0
VIC,CRANBOURNE NORTH,CBNN,CBNN01,620,0,501,1121
WA,CARABOODA,CBOO,CBOO01,0,0,0,0
NSW,COMBOYNE,CBOY,CBOY01,0,0,0,0
NSW,COOMBA,CBPK,CBPK01,324,0,0,324
NSW,CULBURRA,CBRA,CBRA01,0,0,0,0
VIC,COBURG,CBRG,CBRG01,4,0,345,349
NSW,COLLARENEBRI,CBRI,CBRI01,0,37,23,60
NSW,CAMPBELLTOWN,CBTN,CBTN01,8007,0,0,8007
NSW,CAMPBELLTOWN SOUTH,CBTS,CBTS01,30,0,0,30
NSW,COBBITTY,CBTY,CBTY01,0,119,0,119
SA,COOBOWIE,CBWE,CBWE01,153,0,0,153
VIC,CAPE BRIDGEWATER,CBWR,CBWR01,0,0,0,0
WA,CHURCHMAN BROOK,ARMD,CCKH01,484,0,0,484
VIC,CAPE CLEAR,CCLR,CCLR01,179,0,0,179
QLD,MOUNT GRAVATT CARINDALE,MGAT,CDEU01,127,0,0,127
VIC,CARDINIA,CDIA,CDIA01,209,0,0,209
SA,CADELL,CDLL,CDLL01,170,0,0,170
QLD,CONDAMINE,CDME,CDME01,146,0,0,146
SA,CEDUNA,CDNA,CDNA01,343,0,0,343
QLD,CARDWELL,CDWL,CDWL01,202,0,0,202
VIC,CAMPERDOWN,CDWN,CDWN01,495,0,0,495
QLD,CECIL PLAINS,CECI,CECI01,322,0,0,322
NSW,CASTLE HILL TOC,CAST,CEHZ01,780,0,0,780
NSW,CECIL PARK,ERPK,CEPJ01,207,0,0,207
VIC,CERES,CERE,CERE01,0,13,0,13
WA,CERVANTES,CERV,CERV01,149,0,0,149
NSW,CESSNOCK,CESS,CESS01,2186,0,0,2186
VIC,CAMPBELLFIELD,CFLD,CFLD01,0,0,320,320
NSW,COFFS HARBOUR,CFSH,CFSH01,128,0,76,204
VIC,CARDIGAN,CGAN,CGAN01,162,0,0,162
WA,COOLGARDIE,CGDE,CGDE01,194,0,0,194
WA,SOUTH COOGEE,CGEE,CGEE01,61,0,6,67
QLD,CHILLAGOE,CGOE,CGOE01,0,0,0,0
SA,CYGNET RIVER,CGRV,CGRV01,0,0,48,48
SA,CALLINGTON,CGTN,CGTN01,74,0,0,74
VIC,CUDGEWA,CGWA,CGWA01,0,0,0,0
NSW,THE CHANNON,CHAN,CHAN01,99,0,0,99
NSW,CHATSWOOD EXCHANGE,CHAT,CHAT01,141,0,2205,2346
QLD,CHERMSIDE,CHDE,CHDE01,8,0,0,8
VIC,CHURCHILL,CHHL,CHHL01,733,0,344,1077
WA,CHIDLOW,CHID,CHID01,43,0,0,43
QLD,CHINCHILLA,CHIN,CHIN01,0,0,0,0
NSW,CARRAMAR CHIPPING NORTON,CARR,CHIP01,276,0,0,276
NSW,CHIVERTON,CHIV,CHIV01,0,0,0,0
NSW,CHILLINGHAM,CHLM,CHLM01,206,0,0,206
NSW,CHARLESTOWN,CHLS,CHLS01,2170,0,0,2170
QLD,CHARLOTTE,CHLT,CHLT01,982,0,0,982
QLD,CHAPEL HILL,CHPL,CHPL01,1001,0,0,1001
QLD,BUXTONVILLE,CHRD,CHRD01,0,0,14,14
QLD,CHILDERS,CHRS,CHRS01,37,0,0,37
VIC,CHILTERN,CHTN,CHTN01,47,0,0,47
QLD,CHARLEVILLE,CHVE,CHVE01,4,0,357,361
NSW,CORINDI CLARENCE,CICE,CICE01,9,0,0,9
VIC,CAROLINE SPRINGS,DRPK,CIGS01,474,0,0,474
QLD,CAPE KIIMBERLEY,CKIM,CKIM01,0,0,0,0
QLD,COOKTOWN,CKTN,CKTN01,477,0,0,477
TAS,CLAREMONT,CLAR,CLAR01,2435,0,805,3240
VIC,CLAYTON,CLAY,CLAY01,1,0,485,486
VIC,CORAL BANK,CLBK,CLBK01,167,0,0,167
SA,CRYSTAL BROOK,CLBR,CLBR01,258,0,0,258
WA,CABLE BEACH,BRMK,CLEB01,4,0,0,4
QLD,CLIFTON,CLIF,CLIF01,0,0,0,0
NSW,COLEAMBALLY,CLLY,CLLY01,296,0,0,296
QLD,COOLUM BEACH,CLMB,CLMB01,2091,0,849,2940
NSW,COOLAMON,CLMN,CLMN01,7,0,0,7
QLD,CLERMONT,CLMT,CLMT01,111,0,0,111
VIC,CLAYTON GOC BDG 7,CLAY,CLNR01,0,0,0,0
NSW,CLUNES,CLNS,CLNS01,0,241,0,241
QLD,CLOHESY,CLOH,CLOH01,121,0,0,121
QLD,CLONCURRY,CLON,CLON01,0,20,0,20
SA,CLARE,CLRE,CLRE01,768,0,0,768
QLD,CLOSEBURN,CLRN,CLRN01,110,0,0,110
SA,CALOOTE,CLTE,CLTE01,0,24,0,24
TAS,CAMPBELL TOWN,CLTN,CLTN01,271,0,0,271
VIC,CLUNES,CLUN,CLUN01,168,0,0,168
SA,CLEVE,CLVE,CLVE01,131,0,0,131
QLD,CLEVELAND,CLVL,CLVL01,59,0,696,755
NSW,CLOVASS,CLVS,CLVS01,121,0,0,121
SA,COROMANDEL VALLEY,CLVY,CLVY01,1399,0,526,1925
NSW,CURLEWIS,CLWS,CLWS01,216,0,0,216
NSW,CLYBUCCA,CLYA,CLYA01,0,0,0,0
VIC,CLYDE,CLYD,CLYD01,185,0,0,185
NSW,CUMBORAH,CMBH,CMBH01,0,0,0,0
SA,CAMBRAI,CMBR,CMBR01,112,0,0,112
NSW,COOKAMIDGERA,CMDG,CMDG01,0,0,57,57
SA,CURRAMULKA,CMLK,CMLK01,161,0,0,161
VIC,CAMBERWELL,CMLL,CMLL01,1,0,145,146
NSW,CUMNOCK,CMNK,CMNK01,0,0,0,0
SA,CUMMINS,CMNS,CMNS01,241,0,0,241
QLD,COOMINYA,CMYA,CMYA01,0,155,0,155
NSW,COONABARABRAN,CNAN,CNAN01,293,0,471,764
QLD,CLIFTON BEACH,CNBH,CNBH01,528,232,445,1205
NSW,CRANEBROOK,CNBK,CNBK01,3505,0,0,3505
SA,COFFIN BAY,CNBY,CNBY01,298,0,0,298
WA,CUNDERDIN,CNDD,CNDD01,0,179,0,179
NSW,CUNDLETOWN,CNDL,CNDL01,501,0,0,501
NSW,CLIFTON GROVE,CNGE,CNGE01,42,0,0,42
NSW,COPMANHURST,CNHT,CNHT01,153,0,0,153
QLD,CLINTON,CNON,CNON01,148,0,0,148
QLD,CROWS NEST,CNST,CNST01,267,0,0,267
WA,CANNING VALE,CNVL,CNVL01,620,0,0,620
NSW,CARCOAR,COAR,COAR01,170,0,0,170
TAS,COLES BAY,COAY,COAY01,0,128,0,128
VIC,COBDEN,COBD,COBD01,237,0,0,237
VIC,COBRAM,COBM,COBM01,81,0,172,253
VIC,COCKATOO,COCK,COCK01,0,0,328,328
QLD,COEN,COEN,COEN01,0,0,0,0
NSW,COBARGO,COGO,COGO01,207,0,0,207
VIC,COHUNA,COHU,COHU01,411,0,0,411
VIC,COLAC,COLA,COLA01,1235,0,669,1904
VIC,COLBINABBIN,COLB,COLB01,0,0,0,0
VIC,COLDSTREAM,COLD,COLD01,208,0,0,208
NSW,COLLINGULLIE,COLG,COLG01,0,0,0,0
WA,COLLIE,COLI,COLI01,1359,0,364,1723
QLD,COLLINSVILLE,COLL,COLL01,453,0,0,453
NSW,COOMA,COMA,COMA01,472,0,0,472
NSW,COMO,COMO,COMO01,478,0,0,478
SA,COMPTON,COMP,COMP01,0,0,7,7
NSW,CONCORD,CONC,CONC01,582,0,0,582
QLD,CONONDALE,CONO,CONO01,0,42,0,42
QLD,COOBERRIE,COOB,COOB01,324,0,0,324
NSW,COOGEE,COOG,COOG01,137,10,252,399
NSW,COOLAH,COOH,COOH01,160,0,0,160
SA,COOK,INPC,COOK01,0,0,23,23
NSW,COOPERNOOK,COOP,COOP01,290,0,0,290
QLD,COPPABELLA,COPA,COPA01,0,118,0,118
SA,COONALPYN,COPN,COPN01,167,0,0,167
QLD,CORDALBA,CORD,CORD01,264,0,0,264
VIC,CORIO,CORI,CORI01,145,0,673,818
VIC,COROROOKE,CORK,CORK01,116,0,0,116
NSW,CORRIMAL,CORR,CORR01,7171,0,0,7171
QLD,COOROY,CORY,CORY01,33,0,0,33
QLD,COTTONVALE,COTT,COTT01,0,114,0,114
NSW,COLO VALE,COVE,COVE01,2,0,112,114
TAS,COLLINSVALE,COVL,COVL01,119,0,0,119
NSW,COROWA,COWA,COWA01,632,0,367,999
SA,COWELL,COWL,COWL01,96,0,0,96
WA,COWARAMUP,COWP,COWP01,164,0,0,164
NSW,COWRA,COWR,COWR01,1117,0,623,1740
VIC,COWES,COWS,COWS01,946,0,345,1291
VIC,COWWARR,COWW,COWW01,0,121,0,121
QLD,CAPALABA,CPBA,CPBA01,1180,0,9,1189
NSW,CAPTAINS FLAT,CPFT,CPFT01,61,0,0,61
QLD,CAMP HILL,CPHL,CPHL01,327,18,0,345
QLD,COORPAROO,CPRO,CPRO01,1,0,308,309
WA,CRANBROOK,CRAN,CRAN01,158,0,0,158
NSW,CORAMBA,CRBA,CRBA01,291,0,0,291
NSW,COORANBONG,CRBG,CRBG01,571,0,460,1031
VIC,CRAIGIEBURN,CRBN,CRBN01,2247,0,0,2247
VIC,CANTERBURY,CRBY,CRBY01,428,0,338,766
ACT,CRACE,CRCF,CRCF01,417,0,520,937
NSW,CARDIFF,CRDF,CRDF01,1867,0,729,2596
SA,CLARENDON,CRDN,CRDN01,353,0,0,353
NSW,CREMORNE,CREM,CREM01,1125,0,0,1125
VIC,CRESWICK,CRES,CRES01,361,533,0,894
TAS,CRESSY,CREY,CREY01,261,0,0,261
NSW,CASTLEREAGH,CRGH,CRGH01,98,280,0,378
WA,CORRIGIN,CRGN,CRGN01,143,0,0,143
VIC,CRIB POINT,CRIB,CRIB01,740,0,477,1217
VIC,CORINELLA,CRIN,CRIN01,327,0,0,327
NSW,CORAKI,CRKI,CRKI01,228,171,0,399
VIC,CHARLTON,CRLN,CRLN01,46,0,0,46
TAS,CREMORNE,CRMN,CRMN01,348,0,0,348
WA,CURRAMBINE,CRMS,CRMS01,467,0,0,467
VIC,CROYDON,CROH,CROH01,409,0,0,409
NSW,CRONULLA,CRON,CRON01,610,0,0,610
WA,COOROW,CROW,CROW01,324,0,0,324
SA,COOBER PEDY,CRPY,CRPY01,177,0,0,177
QLD,CARRARA,CRRA,CRRA01,0,0,16,16
QLD,CAIRNS,CRSX,CRSX01,2664,0,1501,4165
NSW,CURRAWANG,CRWG,CRWG01,0,0,0,0
SA,CROYDON,CRYD,CRYD01,0,0,507,507
VIC,CORRYONG,CRYG,CRYG01,4,0,0,4
QLD,CAIRNS AIRPORT,CSAP,CSAP01,0,0,44,44
VIC,CHELSEA,CSEA,CSEA01,232,0,1433,1665
NSW,CASINO,CSNO,CSNO01,5,0,230,235
VIC,CHESHUNT,CSNT,CSNT01,105,0,0,105
VIC,CASTERTON,CSTN,CSTN01,13,304,0,317
NT,CASUARINA,CSUF,CSUF01,2438,0,16,2454
VIC,CHELTENHAM,CTAM,CTAM01,210,0,334,544
NSW,CRESCENT HEAD,CTHD,CTHD01,25,0,0,25
NSW,COOTAMUNDRA,CTMA,CTMA01,133,0,0,133
WA,COTTESLOE,CTOE,CTOE01,873,0,0,873
VIC,CARLTON,CTON,CTON01,1101,1,0,1102
QLD,CHARTERS TOWERS,CTRS,CTRS01,710,184,411,1305
NSW,COUTTS CROSSING,CTSX,CTSX01,92,0,0,92
NSW,CLARENCETOWN,CTWN,CTWN01,153,0,0,153
NSW,KINGSCLIFF CASUARINA,KCLF,CUAX01,1,0,183,184
NSW,CULLEN BULLEN,CUBU,CUBU01,155,0,0,155
NSW,CUDAL,CUDL,CUDL01,327,0,0,327
WA,CUE,CUEE,CUEE01,329,0,0,329
TAS,CURRIE,CUIE,CUIE01,36,0,0,36
NSW,CULCAIRN,CULC,CULC01,171,0,0,171
QLD,CUNNAMULLA,CUNN,CUNN01,0,0,0,0
NSW,CURRABUBULA,CURA,CURA01,0,34,0,34
NSW,CURLWAA,CURL,CURL01,0,88,0,88
QLD,CURRUMBIN,CURN,CURN01,0,0,0,0
NSW,CURRARONG,CURR,CURR01,0,0,0,0
QLD,CURTIS,CURT,CURT01,244,0,500,744
QLD,CURRUMBIN WATERS,CURW,CURW01,356,0,0,356
ACT,CIVIC,CVIC,CVIC01,1005,0,881,1886
WA,CARNARVON NORTH,CVNN,CVNN01,97,0,0,97
WA,CARNARVON,CVON,CVON01,1,0,164,165
QLD,CALAVOS,CVOS,CVOS01,263,0,0,263
WA,BEECHBORO CAVERSHAM,BCHS,CVRH01,0,0,0,0
NSW,CROOKWELL,CWLL,CWLL01,97,0,0,97
QLD,COWLEY,CWLY,CWLY01,156,0,0,156
NSW,CURRAWARNA,CWNA,CWNA01,0,0,119,119
VIC,COLLINGWOOD,CWOD,CWOD01,120,12,0,132
NSW,COWPASTURES,CWPS,CWPS01,1821,0,488,2309
SA,COONAWARRA,CWRA,CWRA01,165,0,0,165
QLD,CROYDON,CYDN,CYDN01,0,0,0,0
TAS,CYGNET,CYET,CYET01,357,0,0,357
NSW,CITY SOUTH,CYSH,CYSH01,1148,0,0,1148
WA,CITY BEACH,CYTB,CYTB01,7,0,0,7
QLD,DALBY,DABX,DABX01,938,0,565,1503
TAS,DAVEY,DAEY,DAEY01,2404,0,0,2404
VIC,DARGO,DAGO,DAGO01,162,0,0,162
QLD,DAGUILAR,DAGU,DAGU01,8,0,0,8
NSW,DALLEY,DALL,DALL01,588,0,0,588
QLD,DALRYMPLE HEIGHTS,DALR,DALR01,0,0,0,0
WA,DALWALLINU,DALW,DALW01,260,0,0,260
VIC,DANDENONG,DAND,DAND01,2657,0,0,2657
VIC,DANDENONG NORTH,DANN,DANN01,823,0,0,823
NSW,DAPTO,DAPO,DAPO01,1861,0,212,2073
QLD,DARADGEE,DARA,DARA01,100,0,0,100
WA,DARKAN,DARK,DARK01,0,61,0,61
VIC,DARNUM,DARM,DARM01,67,0,0,67
NSW,DARETON,DARN,DARN01,0,110,0,110
VIC,DARTMOOR,DART,DART01,130,0,0,130
QLD,DAYBORO,DAYB,DAYB01,321,0,201,522
VIC,DAYLESFORD,DAYL,DAYL01,352,0,141,493
WA,DAMPIER PORT AUTHORITY,KAHA,DAZM01,0,0,86,86
NSW,DURANBAH,DBAH,DBAH01,266,0,0,266
NSW,DUBBO,DBBO,DBBO01,3589,0,14,3603
WA,DUNSBOROUGH,DBGH,DBGH01,504,0,0,504
VIC,DIMBOOLA,DBLA,DBLA01,33,0,0,33
WA,DOUBLEVIEW,DBLV,DBLV01,3813,0,0,3813
NSW,DUDLEY,DDLY,DDLY01,1295,0,0,1295
VIC,DEDERANG,DDNG,DDNG01,168,0,0,168
NSW,DUNEDOO,DDOO,DDOO01,264,0,0,264
NT,CASUARINA DA060,BRMH,DDRT01,93,0,0,93
WA,DARDANUP,DDUP,DDUP01,266,0,0,266
VIC,DEAN,DEAN,DEAN01,0,126,0,126
QLD,DEERAL,DEEL,DEEL01,141,0,0,141
NSW,DEE WHY,DEEW,DEEW01,445,0,1834,2279
QLD,DEERAGUN,DEGN,DEGN01,908,0,0,908
NSW,DELEGATE,DELE,DELE01,141,0,0,141
QLD,DELTA,DELT,DELT01,125,0,0,125
VIC,DEANS MARSH,DEMA,DEMA01,107,0,0,107
TAS,DELORAINE,DENE,DENE01,362,0,0,362
VIC,DENISON,DENI,DENI01,168,0,0,168
WA,DENMARK,DENK,DENK01,0,0,221,221
NSW,DENMAN,DENM,DENM01,232,0,0,232
WA,OCEAN BEACH,DENK,DEOB01,0,0,7,7
VIC,DEVON MEADOWS,DEOW,DEOW01,15,0,0,15
VIC,DERRINALLUM,DERI,DERI01,110,0,0,110
TAS,DEVONPORT,DERT,DERT01,3614,0,0,3614
VIC,DIGGERS REST,DEST,DEST01,450,0,0,450
QLD,DINGO BEACH,DGBH,DGBH01,0,131,0,131
NSW,DUNGOG,DGOG,DGOG01,411,0,0,411
NSW,DOUGLAS PARK,DGPK,DGPK01,63,0,0,63
NSW,DANGARSLEIGH,DGSH,DGSH01,0,101,0,101
VIC,DIAMOND CREEK,DICK,DICK01,500,0,0,500
QLD,DIMBULAH,DIMB,DIMB01,291,0,0,291
VIC,DINGEE,DING,DING01,168,0,0,168
TAS,DILSTON,DION,DION01,76,0,0,76
VIC,DINNER PLAIN,DIPL,DIPL01,0,57,0,57
QLD,DIRRANBANDI,DIRR,DIRR01,0,0,51,51
VIC,DIXONS CREEK,DIXK,DIXK01,197,0,0,197
ACT,DEAKIN,DKIN,DKIN01,203,0,0,203
NSW,DELUNGRA,DLGA,DLGA01,0,0,0,0
NSW,DALMENY,DLMY,DLMY01,0,0,0,0
WA,DARLINGTON,DLNT,DLNT01,89,0,0,89
WA,DUMBLEYUNG,DMBL,DMBL01,119,0,0,119
QLD,DOOMADGEE,DMGE,DMGE01,0,5,0,5
WA,DAMPIER,DMPR,DMPR01,213,0,0,213
NSW,DUMARESQ,DMSQ,DMSQ01,0,0,0,0
VIC,DARTMOUTH,DMTH,DMTH01,53,0,10,63
QLD,DOONAN,DNAN,DNAN01,241,0,0,241
VIC,DONCASTER EAST,DNCT,DNCT01,235,0,0,235
VIC,DANDENONG SOUTH,DNDS,DNDS01,10,0,532,542
NSW,DUNGOWAN,DNGN,DNGN01,0,24,0,24
WA,DENHAM,DNHM,DNHM01,176,0,0,176
VIC,DUNKELD,DNKD,DNKD01,0,0,0,0
NSW,DUNOON,DNON,DNON01,116,0,0,116
NSW,DARLINGTON POINT,DNPT,DNPT01,246,0,0,246
NSW,DENILIQUIN,DNQN,DNQN01,37,0,647,684
TAS,DOVER,DOER,DOER01,220,0,0,220
VIC,DONALD,DONA,DONA01,29,0,0,29
VIC,DONCASTER,DONC,DONC01,99,0,365,464
WA,DONGARA,DONG,DONG01,219,0,0,219
WA,DONNYBROOK,DONY,DONY01,489,0,0,489
VIC,DOOEN,DOOE,DOOE01,179,0,0,179
VIC,DOOKIE,DOOK,DOOK01,0,0,0,0
NSW,DOWNSIDE,DOWN,DOWN01,0,0,0,0
WA,MANDURAH CA006,MDRA,DPAM01,374,0,0,374
VIC,DEEPDENE,DPDE,DPDE01,0,0,243,243
NSW,DEEPWATER,DPWR,DPWR01,0,72,0,72
QLD,DRAYTON,DRAY,DRAY01,870,0,214,1084
NSW,DAROOBALGIE,DRBG,DRBG01,0,0,0,0
WA,DERBY,DRBY,DRBY01,14,0,0,14
NSW,DORRIGO NORTH,DRGN,DRGN01,152,0,0,152
NSW,DORRIGO,DRGO,DRGO01,0,0,0,0
NSW,DRAKE,DRKE,DRKE01,0,113,0,113
NSW,DOORALONG,DRLG,DRLG01,243,0,0,243
VIC,DRUMMOND,DRMA,DRMA01,102,0,0,102
NT,DALY RIVER,DLLY,DRMD01,0,0,76,76
VIC,DROMANA,DROM,DROM01,1457,0,331,1788
VIC,DROUIN,DROU,DROU01,1332,0,278,1610
VIC,DEER PARK,DRPK,DRPK01,759,0,3,762
QLD,DARRA,DRRA,DRRA01,58,0,449,507
NSW,DRUMMOYNE,DRUM,DRUM02,181,357,140,678
NT,DARWIN,DRWN,DRWN01,2314,0,0,2314
VIC,DRYSDALE,DRYS,DRYS01,1569,322,861,2752
TAS,DODGES FERRY,DSFY,DSFY01,837,0,0,837
VIC,DARRAWEIT GUIM,DTGM,DTGM01,0,37,0,37
QLD,DUARINGA,DUAR,DUAR01,336,0,0,336
TAS,DUNALLEY,DUEY,DUEY01,288,0,0,288
VIC,DUMBALK,DUMB,DUMB01,0,0,0,0
VIC,DUNOLLY,DUNO,DUNO01,40,0,0,40
QLD,DUNWICH,DUNW,DUNW01,0,0,0,0
QLD,DUNDOWRAN,DUNX,DUNX01,152,0,0,152
NSW,DURAL,DURA,DURA01,99,0,0,99
NSW,DURI,DURI,DURI01,155,0,0,155
VIC,DHURRINGILE EXCHANGE,DURR,DURR01,0,0,0,0
NSW,DURRAS,DURS,DURS01,336,0,0,336
WA,DWELLINGUP,DWEL,DWEL01,194,0,0,194
WA,DOWERIN,DWRC,DWRC01,0,0,0,0
WA,DAWESVILLE,DWSV,DWSV01,773,0,353,1126
NSW,DYERS CROSSING,DYRS,DYRS01,161,0,0,161
QLD,DYSART,DYST,DYST01,523,0,0,523
VIC,EAGLEHAWK,EAHK,EAHK01,75,0,0,75
QLD,EARLVILLE,EARL,EARL01,4343,0,0,4343
NSW,EAST,EAST,EAST02,3589,0,0,3589
WA,EATON,EATN,EATN01,1845,0,0,1845
VIC,EBDEN,EBDN,EBDN01,0,128,0,128
NSW,EBENEZER,EBEN,EBEN01,24,0,0,24
NSW,EBOR,EBOR,EBOR01,0,0,0,0
SA,ECHUNGA,ECGA,ECGA01,83,0,0,83
VIC,ECHUCA,ECHU,ECHU01,1640,0,272,1912
VIC,ECHUCA VILLAGE,ECUI,ECUI01,0,0,0,0
QLD,EMERALD CREEK,EDCK,EDCK01,314,0,0,314
NSW,EDEN,EDEN,EDEN01,0,0,320,320
NSW,EDGECLIFF,EDGE,EDGE01,420,0,2049,2469
QLD,EDGE HILL,EDGL,EDGL01,5133,0,0,5133
SA,EDITHBURGH,EDIT,EDIT01,280,0,0,280
QLD,EDMONTON,EDMO,EDMO01,2268,38,1192,3498
VIC,EDEN PARK,EDPK,EDPK01,0,0,0,0
QLD,EDISON,EDSN,EDSN01,1035,0,0,1035
SA,EDWARDSTOWN,EDWN,EDWN01,340,0,2063,2403
NSW,ENGADINE ENR3,ENGA,EGAX01,215,0,0,215
NSW,EAST GRESFORD,EGRS,EGRS01,0,0,0,0
NSW,EGLINTON,EGTN,EGTN01,190,113,255,558
NSW,EAGLE VALE,MINT,EGVL01,528,0,197,725
NSW,EUGOWRA,EGWR,EGWR01,118,0,0,118
QLD,EIDSVOLD,EIDS,EIDS01,0,103,0,103
VIC,ESKDALE,EKDL,EKDL01,0,0,46,46
VIC,EAST KEW,EKEW,EKEW01,5,0,291,296
VIC,ELAINE,ELAI,ELAI01,152,0,0,152
QLD,EL ARISH,ELAR,ELAR01,122,0,0,122
NSW,ELLENBOROUGH,ELBH,ELBH01,167,0,0,167
WA,ELLENBROOK,ELBK,ELBK01,188,0,0,188
VIC,EILDON,ELDN,ELDN01,198,0,0,198
VIC,ELDORADO,ELDO,ELDO01,124,0,0,124
NSW,ELANDS,ELDS,ELDS01,137,0,0,137
QLD,ELIMBAH,ELIM,ELIM01,595,0,0,595
VIC,ELLASWOOD,ELLA,ELLA01,141,0,0,141
QLD,ELLIOTT HEADS,ELLI,ELLI01,111,0,0,111
NT,ELLIOTT,ELLT,ELLT01,76,0,0,76
VIC,ELMORE,ELMO,ELMO01,108,0,0,108
VIC,ELPHINSTONE,ELPH,ELPH01,141,0,0,141
NSW,ELDERSLIE,ELSE,ELSE01,644,0,389,1033
VIC,ELSTERNWICK,ELSK,ELSK01,288,0,2059,2347
VIC,ELTHAM,ELTM,ELTM01,277,0,0,277
SA,ELLISTON,ELTN,ELTN01,0,0,0,0
NSW,EMERALD BEACH,EMBH,EMBH01,127,0,125,252
QLD,EIMEO,EMEO,EMEO01,773,0,263,1036
QLD,EMERALD,EMER,EMER01,1089,0,959,2048
VIC,EMERALD,EMLD,EMLD01,2,0,242,244
QLD,EMU PARK,EMPK,EMPK01,0,0,208,208
QLD,EIGHT MILE PLAINS,EMPS,EMPS01,563,0,2100,2663
NT,KATHERINE EMUNGALAN OPMDF,KTHN,EMUV01,156,0,0,156
VIC,ENDEAVOUR HILLS,ENDS,ENDS01,613,0,0,613
WA,ENEABBA,ENEA,ENEA01,164,0,0,164
NSW,ENGADINE,ENGA,ENGA01,465,0,2228,2693
QLD,EVERTON PARK,ENPK,ENPK01,109,0,0,109
VIC,EDENHOPE,EOPE,EOPE01,144,0,0,144
VIC,EPPING,EPPG,EPPG01,551,0,693,1244
NSW,EPPING,EPPI,EPPI01,276,0,0,276
VIC,EPSOM,EPSO,EPSO01,80,0,49,129
NSW,EURUNDEREE,ERDE,ERDE01,0,69,0,69
VIC,ERICA,ERIC,ERIC01,0,108,0,108
NSW,ERINA,ERNA,ERNA01,2822,0,260,3082
NT,ERNABELLA,PETN,ERNL01,33,0,0,33
NSW,EDENSOR PARK,ERPK,ERPK01,229,0,0,229
NSW,EVANS HEAD,ESHD,ESHD01,111,0,0,111
QLD,ESK,ESKK,ESKK01,0,0,0,0
NSW,ERSKINE PARK,ESPK,ESPK01,804,0,0,804
WA,ESPERANCE,ESPR,ESPR01,348,0,0,348
NSW,ELLERSTON,ESTN,ESTN01,0,0,0,0
TAS,EAST DEVONPORT,ETDT,ETDT01,825,0,0,825
NSW,ESTELLA,ETLA,ETLA01,598,0,0,598
QLD,ETON,ETON,ETON01,339,0,0,339
NSW,EUNGAI,EUCK,EUCK01,272,0,0,272
SA,EUDUNDA,EUDA,EUDA01,202,0,0,202
QLD,EUMUNDI,EUMU,EUMU01,266,0,0,266
NSW,EMU PLAINS,EUPS,EUPS01,17,0,265,282
VIC,EUROA,EURA,EURA01,36,0,0,36
TAS,EVANDALE,EVAN,EVAN01,316,0,0,316
NT,ROPER RIVER EVA VALLEY,ROPR,EVAV01,44,0,0,44
NSW,EMMAVILLE,EVLE,EVLE01,0,0,0,0
VIC,EVERTON,EVTN,EVTN01,120,0,0,120
VIC,ELWOOD,EWOD,EWOD01,385,0,0,385
NSW,EASTWOOD,EWOO,EWOO01,166,0,0,166
NSW,EWINGSDALE,EWSD,EWSD01,0,0,141,141
NSW,EXETER,EXER,EXER01,350,0,0,350
TAS,EXETER,EXET,EXET01,245,51,0,296
VIC,EXHIBITION,EXHN,EXHN01,1131,0,0,1131
WA,EXMOUTH,EXMH,EXMH01,0,0,0,0
SA,ELIZABETH,EZBH,EZBH01,276,0,0,276
NSW,FALLS CREEK,FALL,FALL01,186,0,0,186
QLD,FARLEIGH,FARL,FARL01,0,165,174,339
QLD,FARNSFIELD,FARN,FARN01,0,0,0,0
NSW,FREDERICKTON,FDTN,FDTN01,239,0,0,239
NSW,FEDERAL,FEDL,FEDL01,45,0,0,45
QLD,FELUGA,FELU,FELU01,93,0,0,93
TAS,FERN TREE,FETE,FETE01,179,0,0,179
VIC,FISH CREEK,FHCK,FHCK01,135,0,0,135
QLD,FERNY HILLS,FHLS,FHLS01,666,0,2254,2920
TAS,FINGAL,FIAL,FIAL01,91,0,0,91
NSW,FIDDLETOWN,FIDD,FIDD01,68,0,0,68
NSW,FIREFLY,FIFY,FIFY01,0,0,0,0
QLD,FINCH HATTON,FINC,FINC01,288,0,0,288
VIC,FINGAL,FING,FING01,28,0,0,28
NSW,FITZGERALDS VALLEY,FITV,FITV01,64,0,0,64
NSW,FIVE DOCK,FIVE,FIVE01,460,0,0,460
VIC,FAWKNER,FKNR,FKNR01,280,0,0,280
QLD,FLAXTON,FLAX,FLAX01,79,0,288,367
VIC,FALLS CREEK,FLCK,FLCK01,33,0,0,33
NSW,FAILFORD,FLFD,FLFD01,209,0,0,209
VIC,FLINDERS,FLIN,FLIN01,116,219,0,335
SA,FLINDERS,FLNF,FLNF01,380,0,0,380
VIC,FLOWERDALE,FLOW,FLOW01,0,76,0,76
WA,FREMANTLE,FMTL,FMTL01,1060,0,683,1743
NSW,FERNBROOK,FNBK,FNBK01,150,0,0,150
NSW,FERNHILL,FNHL,FNHL01,533,14,407,954
NSW,FINLEY,FNLY,FNLY01,316,36,217,569
SA,FINNISS,FNSS,FNSS01,0,9,0,9
NSW,FORSTER,FOER,FOER01,2456,0,420,2876
QLD,INALA FOREST LAKE OPMDF,IALA,FOLK01,1019,0,0,1019
QLD,FOREST HILL,FORE,FORE01,187,0,0,187
TAS,FOREST,FORT,FORT01,270,0,0,270
VIC,FOSTER,FOSR,FOSR01,286,0,0,286
TAS,FORTH,FOTH,FOTH01,345,0,0,345
SA,FRANCES,FRAN,FRAN01,0,16,0,16
NSW,FORBES,FRBS,FRBS01,423,0,445,868
NSW,FREEMANS REACH,FRCH,FRCH01,82,0,0,82
VIC,FRESHWATER CREEK,FREK,FREK01,99,0,0,99
QLD,FRENCHVILLE,FREL,FREL01,4839,0,0,4839
NSW,FRENCHS FOREST,FREN,FREN01,1161,0,0,1161
QLD,FRESHWATER,FRES,FRES01,984,0,683,1667
WA,FORRESTFIELD,FRFD,FRFD01,43,314,339,696
TAS,FRANKLIN,FRIN,FRIN01,233,0,0,233
SA,FREELING,FRLG,FRLG01,326,0,0,326
VIC,FERNY CREEK,FRNK,FRNK01,0,0,418,418
VIC,FRANKSTON,FRTN,FRTN01,118,0,0,118
VIC,FOOTSCRAY,FSRY,FSRY01,840,0,2177,3017
WA,FORRESTDALE,FTDL,FTDL01,287,0,0,287
VIC,FERNTREE GULLY,FTGY,FTGY01,1685,0,3,1688
VIC,FLEMINGTON,FTON,FTON01,49,0,2014,2063
NSW,FOREST REEFS,FTRF,FTRF01,163,0,0,163
WA,FITZROY CROSSING,FTZR,FTZR01,6,0,0,6
QLD,FERNVALE,FVLE,FVLE01,361,0,0,361
NSW,FITZROY FALLS,FYFS,FYFS01,0,44,0,44
NSW,FAIRY HILL,FYHL,FYHL01,174,0,0,174
ACT,FYSHWICK,FYSK,FYSK01,475,0,0,475
VIC,GLENMAGGIE,GAGI,GAGI01,0,120,0,120
NSW,GANMAIN,GAIN,GAIN01,0,91,0,91
VIC,GARDENVALE,GALE,GALE01,151,0,0,151
NSW,GALSTON,GALS,GALS01,72,0,0,72
VIC,GARFIELD,GARF,GARF01,0,19,132,151
QLD,GARGETT,GARG,GARG01,94,0,0,94
VIC,GLENGARRY,GARY,GARY01,321,0,0,321
QLD,GATTON,GATT,GATT01,340,0,0,340
QLD,GAYNDAH,GAYN,GAYN01,52,0,0,52
QLD,GOOMBUNGEE,GBGE,GBGE01,228,0,0,228
QLD,GOOMBURRA,GBRA,GBRA01,0,0,0,0
VIC,GREENSBOROUGH,GBRH,GBRH01,3069,0,0,3069
NSW,GUNDAGAI,GDAI,GDAI01,386,0,0,386
TAS,GARDEN ISLAND CREEK,GDCK,GDCK01,113,0,0,113
NT,NOONAMAH GOODE ROAD,NNMH,GDET01,227,0,0,227
QLD,GOODNA,GDNA,GDNA01,1477,0,0,1477
NSW,GUNDAROO,GDRO,GDRO01,105,0,0,105
VIC,GEELONG,GEEM,GEEM01,736,0,0,736
VIC,GELLIBRAND RIVER,GELR,GELR01,0,49,0,49
VIC,GEMBROOK,GEMB,GEMB01,33,0,0,33
QLD,GEMFIELDS,GEMF,GEMF01,336,0,0,336
VIC,GLEN VALLEY,GENV,GENV01,0,0,21,21
TAS,GEEVESTON,GEON,GEON01,385,0,0,385
QLD,GEORGETOWN,GEOR,GEOR01,0,66,0,66
VIC,GRASSMERE,GERE,GERE01,143,0,0,143
NSW,GERRINGONG,GERN,GERN01,1136,0,503,1639
TAS,GEORGE TOWN,GEWN,GEWN01,332,47,0,379
NSW,GRENFELL,GFEL,GFEL01,0,0,0,0
WA,GLENFIELD EXCHANGE WA,GFLD,GFLD01,666,0,0,666
WA,GLEN FORREST,GFOR,GFOR01,114,0,241,355
NSW,GRIFFITH,GFTH,GFTH01,1842,0,285,2127
NSW,GILGAI,GGAI,GGAI01,122,0,0,122
NSW,GEARYS GAP,GGAP,GGAP01,0,0,0,0
NSW,GULARGAMBONE,GGBN,GGBN01,0,15,0,15
NSW,GRONG GRONG,GGGG,GGGG01,0,45,0,45
ACT,GUNGAHLIN,CRCF,GGHA01,342,0,0,342
WA,GIDGEGANNUP,GGNP,GGNP01,0,0,42,42
NT,DARWIN GREGORY STREET,DRWN,GGRT01,1459,0,0,1459
WA,GLENFIELD G004,GFLD,GHLX01,179,127,0,306
QLD,GLASSHOUSE MOUNTAINS,GHMT,GHMT01,156,0,0,156
NSW,GILGANDRA,GILG,GILG01,315,0,0,315
QLD,GILSTON,GILS,GILS01,0,0,0,0
QLD,GIN GIN,GINN,GINN01,126,0,0,126
NT,HOWARD SPRINGS GIRRAWEEN,HDSS,GIRN01,0,0,0,0
WA,GIRRAWHEEN,GIRR,GIRR01,540,0,2105,2645
QLD,GIRU,GIRU,GIRU01,0,0,0,0
VIC,GISBORNE,GISB,GISB01,1491,0,0,1491
NSW,GLENBROOK,GLBK,GLBK01,583,0,0,583
NSW,GOULBURN,GLBN,GLBN01,2057,0,382,2439
SA,GLADSTONE,GLDE,GLDE01,294,0,0,294
WA,GUILDERTON,GLDN,GLDN01,117,0,0,117
NSW,GLEBE,GLEB,GLEB01,844,0,0,844
NSW,GLENORIE,GLEN,GLEN01,0,0,408,408
NSW,GLENFIELD PARK,GLFD,GLFD01,1784,0,517,2301
NSW,GILGOOMA,GLGA,GLGA01,0,0,0,0
NSW,GOOLOOGONG,GLGG,GLGG01,344,0,0,344
NSW,GOL GOL,GLGL,GLGL01,1,0,156,157
TAS,GLENORCHY,GLHY,GLHY01,3763,0,420,4183
VIC,GLEN IRIS,GLIS,GLIS01,833,0,443,1276
SA,GLENELG,GLLG,GLLG01,84,0,2182,2266
NSW,GALONG,GLNG,GLNG01,0,0,0,0
VIC,GLENTHOMPSON,GLON,GLON01,0,40,0,40
NSW,GLOUCESTER,GLOS,GLOS01,367,0,0,367
NSW,GULPA,GLPA,GLPA01,0,0,0,0
NSW,GLENQUARRY,GLQY,GLQY01,0,51,0,51
WA,GELORUP,GLRP,GLRP01,1437,0,232,1669
TAS,GLENGARRY,GLRY,GLRY01,0,66,0,66
SA,GLOSSOP,GLSP,GLSP01,140,0,0,140
QLD,GLADSTONE,GLST,GLST01,317,0,320,637
WA,GERALDTON,GLTN,GLTN01,1565,0,0,1565
VIC,GLENAROUA,GLVA,GLVA01,0,0,0,0
SA,GOOLWA,GLWA,GLWA01,692,0,212,904
WA,GOOMALLING,GMLG,GMLG01,226,0,0,226
QLD,GOOMERI,GMRI,GMRI01,29,0,0,29
QLD,GLAMORGAN VALE,GMVE,GMVE01,179,0,0,179
VIC,GNARWARRE,GNAR,GNAR01,0,0,20,20
QLD,GOLDEN BEACH,GNBH,GNBH01,4,0,105,109
WA,GNARABUP BEACH,GNBP,GNBP01,170,0,0,170
SA,GLENCOE,GNCE,GNCE01,63,0,0,63
QLD,GLENDORF,GNDF,GNDF01,0,0,0,0
QLD,GLENDEN,GNDN,GNDN01,205,0,0,205
NSW,GUNDY,GNDY,GNDY01,66,0,0,66
SA,GOLDEN GROVE,GNGE,GNGE01,283,23,7,313
WA,GINGIN,GNGN,GNGN01,171,0,0,171
NSW,GOONENGERRY,GNGY,GNGY01,0,0,0,0
TAS,GLEN HUON,GNHN,GNHN01,155,0,0,155
NSW,GLEN INNES,GNIS,GNIS01,122,0,321,443
QLD,GREENMOUNT,GNMT,GNMT01,282,0,0,282
NSW,GUNNING,GNNG,GNNG01,150,0,0,150
WA,GNOWANGERUP,GNOW,GNOW01,168,0,0,168
NSW,GLENREAGH,GNRH,GNRH01,309,0,0,309
VIC,GLENROY,GNRY,GNRY01,13,0,518,531
QLD,GORDONVALE,GNVE,GNVE01,3,0,253,256
VIC,GOLDEN BEACH,GOBH,GOBH01,45,0,0,45
NSW,GOOLGOWI,GOGI,GOGI01,0,0,30,30
NSW,GOONELLABAH,GONH,GONH01,140,0,569,709
NSW,GOOLMANGAR,GOOL,GOOL01,53,0,0,53
QLD,GOONDIWINDI,GOON,GOON01,13,0,613,626
VIC,GOORNONG,GOOR,GOOR01,128,0,0,128
QLD,GOOVIGEN,GOOV,GOOV01,165,0,0,165
VIC,GORDON,GORD,GORD01,231,0,0,231
VIC,GOROKE,GORK,GORK01,122,0,0,122
WA,GOSNELLS,GOSN,GOSN01,143,0,0,143
SA,GOSSE,GOSS,GOSS01,0,0,26,26
QLD,GOWRIE JUNCTION,GOWJ,GOWJ01,498,0,0,498
SA,GEPPS CROSS,GPCS,GPCS01,2234,0,3,2237
NT,ARNHEM EAST GAPUWIYAK,ARNE,GPWK01,176,0,0,176
QLD,GRACEMERE,GRAC,GRAC01,115,98,0,213
NSW,GRANVILLE,GRAN,GRAN01,13,0,0,13
QLD,GREENBANK,GRBK,GRBK01,322,0,368,690
WA,GREENBUSHES,GRBS,GRBS01,162,0,0,162
VIC,GOORAMBAT,GRBT,GRBT01,0,27,0,27
QLD,GRANDCHESTER,GRCH,GRCH01,96,0,0,96
NSW,GRETA,GREA,GREA01,383,0,0,383
NSW,GREENWELL POINT,GREN,GREN01,0,15,0,15
NSW,GREVILLIA,GREV,GREV01,147,0,0,147
WA,GREENFIELDS,MDRA,GREX03,352,0,400,752
NSW,GARANGULA,GRGA,GRGA01,0,0,0,0
VIC,GIRGARRE,GRGE,GRGE01,0,0,0,0
NSW,GEURIE,GRIE,GRIE01,206,0,0,206
NSW,GOROKAN,GRKN,GRKN01,5985,0,429,6414
VIC,GREENVALE,GRLE,GRLE01,320,0,0,320
WA,GREENMOUNT,GRMT,GRMT01,112,0,0,112
SA,GREENOCK,GRNK,GRNK01,160,0,0,160
NSW,GRAFTON,GRNN,GRNN01,5,0,418,423
VIC,GROVEDALE,GROX,GROX01,378,0,0,378
SA,GAWLER RIVER,GRRR,GRRR01,0,0,0,0
QLD,GRANTHAM,GRTM,GRTM01,0,0,0,0
VIC,GRANTVILLE,GRTV,GRTV01,0,0,0,0
VIC,GRUYERE,GRUY,GRUY01,173,0,0,173
TAS,GROVE,GRVE,GRVE01,0,254,0,254
VIC,GLENROWAN,GRWN,GRWN01,254,0,0,254
VIC,GLADYSDALE,GSDE,GSDE01,17,0,0,17
NSW,GOSFORD,GSFD,GSFD01,2102,0,2304,4406
TAS,GRETNA,GTNA,GTNA01,160,0,0,160
NSW,GULF CREEK,GUCK,GUCK01,0,0,17,17
SA,GLENUNGA,GUGA,GUGA01,468,1,726,1195
QLD,GULLIVER RIVERSIDE GARDEN,GULL,GUHY01,88,0,0,88
VIC,GUILDFORD,GUID,GUID01,96,0,0,96
NSW,GUILDFORD,GUIL,GUIL01,491,0,0,491
NSW,GULGONG,GULG,GULG01,199,0,0,199
QLD,GULLIVER,GULL,GULL01,4693,0,427,5120
SA,GUMERACHA,GUMA,GUMA01,92,0,0,92
QLD,GUNALDA,GUNA,GUNA01,175,0,0,175
NSW,GUNNEDAH,GUNN,GUNN01,82,0,0,82
VIC,GUNBOWER,GUNR,GUNR01,0,0,0,0
QLD,GUNUNA,GUUA,GUUA01,0,0,0,0
NSW,GIRVAN,GVAN,GVAN01,0,0,121,121
NSW,GROSE VALE,GVLE,GVLE01,0,0,485,485
NSW,GRAVESEND,GVSD,GVSD01,0,0,0,0
WA,GWAMBYGINE,GWAM,GWAM01,0,0,46,46
VIC,GREAT WESTERN,GWES,GWES01,153,0,0,153
NSW,GRAWIN,GWIN,GWIN01,0,0,38,38
NT,GALIWINKU NHULUNBUY,GWKU,GWKU01,280,0,0,280
NSW,GLEN WILLIAM,GWLM,GWLM01,0,43,0,43
SA,GAWLER,GWLR,GWLR01,1698,0,281,1979
SA,GREENWITH,GWTH,GWTH01,126,0,349,475
QLD,GYMPIE,GYMP,GYMP01,3694,0,19,3713
VIC,GLENLYON,GYON,GYON01,131,0,0,131
NSW,GUYRA,GYRA,GYRA01,267,0,0,267
VIC,HADDON,HADD,HADD01,457,0,0,457
TAS,HADSPEN,HAEN,HAEN01,833,0,0,833
SA,HAWKER,HAER,HAER01,298,0,0,298
TAS,HAGLEY,HAEY,HAEY01,168,0,0,168
VIC,HALLAM,HALA,HALA01,95,0,0,95
QLD,HALIFAX,HALI,HALI01,293,0,0,293
ACT,HALL,HALL,HALL01,213,0,0,213
NSW,HALLIDAYS POINT,HALP,HALP01,445,0,351,796
WA,HALLS HEAD,MDRA,HALR02,1778,502,0,2280
QLD,HAMILTON ISLAND RT OP MDF,AIRL,HAMI01,0,0,0,0
NSW,HAMILTON,HAMN,HAMN01,2841,746,0,3587
QLD,HAMPTON,HAMP,HAMP01,0,85,0,85
WA,HAMERSLEY,HAMS,HAMS01,703,0,2552,3255
WA,HANNANS,KGLE,HANN01,281,0,0,281
NSW,HANNAM VALE,HANV,HANV01,0,45,0,45
NSW,HANWOOD,HANW,HANW01,157,0,0,157
TAS,HAMILTON,HAON,HAON01,0,0,0,0
NSW,HARBORD,HARB,HARB01,482,0,0,482
VIC,HARCOURT,HARC,HARC01,240,0,0,240
NSW,HARRINGTON,HARN,HARN01,279,0,0,279
WA,HARVEY,HARV,HARV01,677,0,0,677
NSW,HASTINGS POINT,HASP,HASP01,312,0,290,602
VIC,HASTINGS,HAST,HAST01,918,0,561,1479
NSW,HAT HEAD,HATD,HATD01,162,0,0,162
QLD,HATTON VALE,HATT,HATT01,420,0,0,420
VIC,HAWKESDALE,HAWK,HAWK01,0,0,0,0
VIC,HAWTHORN,HAWN,HAWN01,1,0,0,1
NSW,HAY,HAYY,HAYY01,151,0,359,510
NSW,HELENSBURGH,HBGH,HBGH01,110,0,0,110
QLD,HOMEBUSH,HBSH,HBSH01,175,0,0,175
VIC,HEIDELBERG,HDBG,HDBG01,382,0,286,668
NSW,HARWOOD,HDIS,HDIS01,0,0,41,41
NSW,HERMIDALE,HDLE,HDLE01,0,0,0,0
QLD,HIGHLAND PARK,HDPK,HDPK01,65,0,210,275
NT,HOWARD SPRINGS,HDSS,HDSS01,93,0,0,93
QLD,HODGSON VALE,HDSV,HDSV01,0,0,183,183
VIC,HEATHMERE,HEAH,HEAH01,0,0,0,0
VIC,HEATHCOTE,HEAT,HEAT01,0,0,45,45
NSW,HERONS CREEK,HECK,HECK01,0,53,0,53
SA,HOPE FOREST,HEFT,HEFT01,88,0,0,88
QLD,HELIDON,HELI,HELI01,384,0,0,384
NSW,HERNANI,HENI,HENI01,0,0,0,0
NSW,HENTY,HENT,HENT01,0,93,84,177
QLD,HERBERTON,HERB,HERB01,59,0,0,59
WA,HERNE HILL,HERL,HERL01,264,0,0,264
NT,HERMANNSBERG,PETN,HERM01,59,0,0,59
VIC,HESKET,HESK,HESK01,160,0,0,160
VIC,HEATHERTON,HETH,HETH01,3,0,288,291
VIC,HOPETOUN,HETN,HETN01,214,0,0,214
VIC,HEYWOOD,HEYD,HEYD01,167,0,0,167
VIC,HEYFIELD,HEYF,HEYF01,377,0,0,377
QLD,HIGHFIELDS,HFDS,HFDS01,1,0,276,277
QLD,HIGHVALE,HGLE,HGLE01,385,0,0,385
VIC,HIGHETT,HGTT,HGTT01,255,0,211,466
SA,HINDMARSH TIERS,HHTS,HHTS01,0,0,0,0
WA,HILTON,HILN,HILN01,1893,0,0,1893
NSW,HINTON,HINT,HINT01,201,0,0,201
TAS,HILLWOOD,HIOD,HIOD01,279,0,0,279
NSW,HIGH RANGE,HIRA,HIRA01,239,0,0,239
NSW,HOSKINSTOWN,HKTN,HKTN01,174,0,0,174
NSW,HILLTOP,HLTP,HLTP01,0,0,0,0
VIC,HOTHAM HEIGHTS,HMHS,HMHS01,0,0,0,0
NSW,HAYMARKET,HMKT,HMKT01,2701,0,0,2701
VIC,HAMILTON,HMON,HMON01,1115,0,0,1115
SA,HAHNDORF,HNDF,HNDF01,662,0,0,662
SA,HENLEY BEACH,HNLY,HNLY01,330,0,1467,1797
TAS,HOWRAH,HOAH,HOAH01,1994,0,0,1994
VIC,HODDLES CREEK,HODD,HODD01,125,0,0,125
QLD,HOPE ISLAND,HOID,HOID01,310,0,467,777
NSW,HOLBROOK,HOLB,HOLB01,172,0,0,172
NSW,HOLSWORTHY,HOLS,HOLS01,419,0,0,419
QLD,HOME HILL,HOMA,HOMA01,652,0,0,652
NSW,HOMEBUSH,HOME,HOME01,816,0,0,816
WA,HOPETOUN,HOPE,HOPE01,275,0,0,275
NSW,HOXTON PARK,MILL,HOPJ01,2944,0,0,2944
VIC,HORFIELD,HORF,HORF01,179,0,0,179
VIC,HORSHAM,HORM,HORM01,787,0,2,789
NSW,HORNSBY,HORN,HORN01,337,0,362,699
NSW,HORSLEY PARK,HORS,HORS01,9,1,251,261
NSW,HOWLONG,HOWL,HOWL01,51,0,0,51
NT,HOWARD SPRINGS PRISON,HDSS,HOZC01,188,0,0,188
SA,HAMPSTEAD,HPSD,HPSD01,313,0,2198,2511
NSW,HARDEN,HRDN,HRDN01,63,0,0,63
SA,HARRIET,HRET,HRET01,0,0,26,26
NSW,HORSESHOE CREEK,HRSK,HRSK01,152,0,0,152
NSW,HARTLEY,HRTY,HRTY01,82,0,0,82
WA,HALLS CREEK,HSCK,HSCK01,118,0,0,118
VIC,HALLS GAP,HSGP,HSGP01,0,24,0,24
WA,HAMERSLEY DA119,HAMS,HSLV01,137,0,0,137
VIC,HARSTON,HSTN,HSTN01,159,0,0,159
QLD,HARRISVILLE,HSVE,HSVE01,214,0,0,214
WA,GOSNELLS HUNTINGDALE,GOSN,HTDS01,0,0,0,0
VIC,HARTWELL,HTLL,HTLL01,164,2,0,166
NSW,HILLSTON,HTON,HTON01,175,0,0,175
QLD,HUGHENDEN,HUGH,HUGH01,362,0,0,362
NSW,HUNTERS HILL,HUHL,HUHL01,400,0,673,1073
TAS,HUONVILLE,HULE,HULE01,599,0,0,599
VIC,HUNTLY,HUNY,HUNY01,49,0,0,49
NSW,HUONBROOK,HUON,HUON01,161,0,0,161
VIC,HURSTBRIDGE,HURB,HURB01,0,0,245,245
NSW,HURSTVILLE,HURS,HURS01,71,0,0,71
NSW,HUSKISSON,HUSK,HUSK01,246,0,312,558
VIC,HEALESVILLE,HVIL,HVIL01,724,0,476,1200
NSW,HALLSVILLE,HVLE,HVLE01,142,0,0,142
QLD,HOLLOWAY BEACH,HWCH,HWCH01,509,0,339,848
QLD,HOWARD,HWRD,HWRD01,317,0,0,317
WA,HYDEN,HYDN,HYDN01,112,0,0,112
VIC,HARRIETVILLE,HYLE,HYLE01,0,39,0,39
QLD,HAY POINT,HYPT,HYPT01,0,291,0,291
NSW,HAZELBROOK,HZBK,HZBK01,336,0,0,336
VIC,HAZELWOOD NORTH,HZWD,HZWD01,280,0,0,280
QLD,INALA,IALA,IALA01,961,0,0,961
QLD,INGHAM,IGHM,IGHM01,738,0,335,1073
VIC,INVERGORDON,IGON,IGON01,0,0,0,0
SA,INGLEWOOD,IGWD,IGWD01,123,0,0,123
NSW,IVANHOE,IHOE,IHOE01,154,0,0,154
NSW,ILUKA,ILKA,ILKA01,52,0,0,52
TAS,ILFRAVILLE,ILLE,ILLE01,191,0,0,191
VIC,ILLOWA,ILLO,ILLO01,0,114,0,114
QLD,IMBIL,IMBI,IMBI01,204,0,0,204
NSW,INDIGO VALLEY,INDV,INDV01,78,0,0,78
QLD,INGLEWOOD,INGD,INGD01,186,0,0,186
NSW,INGLEBURN,INGL,INGL01,446,24,2212,2682
QLD,INGLESIDE,INGS,INGS01,0,0,0,0
QLD,INJUNE,INJU,INJU01,0,57,0,57
NSW,INVERELL,INLL,INLL01,1,0,283,284
VIC,INVERLOCH,INLO,INLO01,1109,0,0,1109
QLD,INNISFAIL,INNI,INNI01,1197,0,0,1197
VIC,INVERLEIGH,INVR,INVR01,161,0,0,161
VIC,INGLEWOOD,INWD,INWD01,100,0,0,100
SA,INDIAN PACIFIC ILUKA MINE,INPC,INXZ01,0,0,0,0
QLD,IPSWICH,IPSW,IPSW01,84,0,746,830
VIC,IRREWARRA,IRRE,IRRE01,0,0,20,20
VIC,IRYMPLE,IRYM,IRYM01,62,0,277,339
QLD,ISISFORD,ISIS,ISIS01,0,0,0,0
QLD,ISLAND POINT,ISLP,ISLP01,248,0,409,657
VIC,IVANHOE,IVAN,IVAN01,0,0,475,475
QLD,IRVINEBANK,IVBK,IVBK01,0,0,0,0
NSW,INVERGOWRIE,IVGE,IVGE01,284,0,0,284
SA,JAMESTOWN,JAME,JAME01,520,0,0,520
NSW,JAMBEROO,JAMO,JAMO01,184,0,0,184
QLD,JANDOWAE,JAND,JAND01,0,363,0,363
NT,JABIRU,JARU,JARU01,87,0,0,87
QLD,JARVISFIELD,JARV,JARV01,0,0,180,180
QLD,JIMBOOMBA,JBBB,JBBB01,234,0,313,547
ACT,JERRABOMBERRA,JBRA,JBRA01,429,0,0,429
VIC,JACK RIVER,JCKR,JCKR01,0,67,0,67
WA,JOONDALUP,JDLP,JDLP01,1389,0,0,1389
NSW,JINDERA,JDRA,JDRA01,136,0,0,136
NSW,JERILDERIE,JDRE,JDRE01,226,0,0,226
VIC,JINDIVICK,JDVK,JDVK01,0,38,31,69
VIC,JEPARIT,JEPA,JEPA01,0,0,0,0
WA,JERRAMUNGUP,JERR,JERR01,0,55,0,55
NSW,JIGGI,JIGI,JIGI01,0,0,0,0
NSW,JINDABYNE EAST,JINE,JINE01,301,0,0,301
NSW,JINDABYNE,JINJ,JINJ01,217,0,290,507
WA,JANDAKOT,JKOT,JKOT01,470,5,31,506
WA,JANDAKOT AIRPORT,JKOT,JKTP01,5,0,362,367
WA,JINDALEE,JLEE,JLEE01,792,0,0,792
VIC,JAMIESON,JMSN,JMSN01,10,0,0,10
NSW,JUNCTION HILL,JNHL,JNHL01,192,0,0,192
NSW,JOCELYN,JOCN,JOCN01,0,0,0,0
QLD,JONDARYAN,JOND,JOND01,172,0,0,172
QLD,JOHNSTOWN WEST,JONW,JONW01,0,0,10,10
NT,ROPER RIVER DJILKMINNGAN,ROPR,JQZK01,0,0,14,14
QLD,JAMBOREE HEIGHTS,JREE,JREE01,4213,0,0,4213
NSW,JERRYS PLAINS,JRRY,JRRY01,0,0,0,0
VIC,JUNORTOUN,JRTN,JRTN01,111,0,118,229
WA,JANDAKOT SOUTH,JTSX,JTSX01,472,0,0,472
NSW,JUGIONG,JUGI,JUGI01,0,76,0,76
QLD,JULIA CREEK,JULI,JULI01,0,14,0,14
QLD,JUNDAH,JUND,JUND01,104,0,0,104
NSW,JUNEE,JUNE,JUNE01,178,0,0,178
WA,JURIEN,JURI,JURI01,255,0,0,255
VIC,JORDANVILLE,JVLE,JVLE01,249,0,0,249
NSW,JERVIS BAY,JVSB,JVSB01,0,46,0,46
NSW,BEROWRA DA043 JWMB,BERO,JWMB01,0,0,0,0
WA,KALGAN,KAAN,KAAN01,65,0,0,65
SA,KALANGADOO,KADO,KADO01,0,0,6,6
QLD,KALLANGUR MANGO HILL OP,KLGR,KAER01,1193,110,0,1303
NT,VICTORIA RIVER KALKARINGI,VIER,KAGI01,76,0,0,76
WA,KARRATHA,KAHA,KAHA01,220,0,0,220
WA,NICKOL,KAHA,KAHJ02,242,0,0,242
WA,KARRATHA SOUTH,KAHA,KAHS01,0,28,0,28
QLD,KAIRI,KAIR,KAIR01,98,0,0,98
VIC,KINGLAKE,KAKE,KAKE01,353,0,0,353
VIC,KINGLAKE WEST,KAKW,KAKW01,241,0,0,241
QLD,KALBAR,KALB,KALB01,0,248,0,248
VIC,KARINGAL,KALG,KALG01,2215,990,2042,5247
WA,KALBARRI,KALI,KALI01,435,0,0,435
WA,KALAMUNDA,KALM,KALM01,306,0,279,585
WA,KAMBALDA,KAMB,KAMB01,317,0,0,317
NSW,KANDOS,KAND,KAND01,49,0,0,49
SA,KANGARILLA,KANG,KANG01,105,0,0,105
VIC,KANIVA,KANI,KANI01,147,0,0,147
NSW,KANGAROO VALLEY,KANV,KANV01,178,0,11,189
SA,KAPUNDA,KAPU,KAPU01,376,48,0,424
TAS,KAROOLA,KARO,KARO01,151,0,0,151
QLD,KARUMBA,KARU,KARU01,29,0,0,29
WA,KATANNING,KATG,KATG01,667,0,0,667
VIC,KATAMATITE,KATM,KATM01,156,0,0,156
VIC,KATANDRA WEST,KATW,KATW01,0,0,0,0
ACT,KAMBAH,KBAH,KBAH01,1230,0,0,1230
WA,KELLERBERRIN,KBRN,KBRN01,173,0,0,173
NT,KATHERINE DA004,KTHN,KCAP01,168,0,0,168
NSW,KINGSCLIFF,KCLF,KCLF01,0,0,293,293
SA,KADINA,KDNA,KDNA01,634,0,0,634
WA,KEWDALE,KEDL,KEDL01,0,20,260,280
NSW,KELLYVILLE,KELL,KELL01,4060,0,0,4060
WA,KELMSCOTT,KELM,KELM01,1280,0,267,1547
QLD,KELSO,KELO,KELO01,1586,0,784,2370
NSW,KEMPS CREEK,KEMP,KEMP01,189,0,0,189
TAS,KETTERING,KENG,KENG01,201,0,0,201
QLD,KENILWORTH,KENI,KENI01,0,155,0,155
QLD,KENNEDY,KENN,KENN01,105,0,0,105
NSW,KENSINGTON,KENS,KENS01,779,0,0,779
NSW,KENTHURST,KENT,KENT01,270,0,83,353
TAS,KEMPTON,KEON,KEON01,131,0,0,131
SA,KEPPOCH,KEPH,KEPH01,0,0,30,30
QLD,KEPPEL SANDS,KEPP,KEPP01,86,0,0,86
VIC,KERANG,KERA,KERA01,441,0,0,441
VIC,KERRISDALE,KERS,KERS01,0,0,183,183
SA,KEITH,KETH,KETH01,0,0,0,0
VIC,KIEWA,KEWA,KEWA01,168,0,0,168
VIC,KEW,KEWE,KEWE01,31,0,0,31
VIC,KEYSBOROUGH,KEYS,KEYS01,860,0,381,1241
NT,ALICE SPRINGS,ALSS,KGAF01,366,0,0,366
NSW,KOORAINGHAT,KGAT,KGAT01,312,0,0,312
WA,KALGOORLIE,KGLE,KGLE01,294,0,0,294
NSW,KANGALOON,KGLN,KGLN01,0,89,0,89
VIC,KINGS PARK,KGPK,KGPK01,1883,0,73,1956
VIC,KANGAROO FLAT,KGRO,KGRO01,1408,0,0,1408
SA,KINGSTON SE,KGSN,KGSN01,224,0,0,224
VIC,KERGUNYAH,KGYH,KGYH01,0,118,0,118
NSW,KHANCOBAN,KHAN,KHAN01,159,0,0,159
VIC,KIALLA EAST,KIAE,KIAE01,178,0,0,178
VIC,KIALLA,KIAL,KIAL01,1019,0,382,1401
NSW,KIAMA,KIAM,KIAM01,35,0,50,85
SA,KIMBA,KIBA,KIBA01,187,0,0,187
VIC,KILLARNEY,KILA,KILA01,0,70,0,70
QLD,KILKIVAN,KILK,KILK01,90,0,0,90
NSW,KILLARA,KILL,KILL01,303,0,0,303
VIC,KILMORE,KILM,KILM01,1503,0,133,1636
WA,KING RIVER,KINE,KINE01,153,0,0,153
NSW,KINGSGROVE,KING,KING01,624,0,0,624
QLD,KIRWAN,KIRN,KIRN01,6234,0,4,6238
TAS,KINGSTON,KITN,KITN01,2082,0,50,2132
VIC,KALKALLO,KKLO,KKLO01,77,0,0,77
NSW,KURRI KURRI,KKRI,KKRI01,113,0,0,113
NSW,KILLABAKH CREEK,KLCK,KLCK01,0,81,0,81
QLD,KILCOY,KLCY,KLCY01,1,0,0,1
QLD,KALLANGUR,KLGR,KLGR01,1714,0,10,1724
VIC,KILMANY,KLMY,KLMY01,0,76,0,76
QLD,KILLARNEY,KLNY,KLNY01,0,203,0,203
VIC,KEILOR,KLOR,KLOR01,431,0,0,431
NSW,KEMPSEY,KMSY,KMSY01,725,0,0,725
NSW,KINCUMBER,KNBR,KNBR01,1143,0,319,1462
NSW,KENDALL,KNDL,KNDL01,182,0,0,182
SA,KINGSCOTE,KNGE,KNGE01,399,0,0,399
QLD,KIN KIN,KNKN,KNKN01,172,0,0,172
NSW,KENTUCKY,KNKY,KNKY01,0,0,0,0
VIC,KNOWSLEY,KNOW,KNOW01,0,139,0,139
WA,KUNUNURRA,KNRF,KNRF01,1,0,0,1
NSW,KENT STREET EXCHANGE,KNST,KNST01,347,0,0,347
NSW,KENTHURST NORTH,KNTH,KNTH01,109,0,0,109
VIC,KOONWARRA,KNWA,KNWA01,0,0,0,0
VIC,KOBYBOYN,KOBY,KOBY01,0,0,0,0
NSW,KOGARAH,KOGA,KOGA01,407,0,0,407
WA,KOJONUP,KOJO,KOJO01,197,0,0,197
QLD,KOLAN SOUTH,KOLA,KOLA01,228,0,0,228
WA,KONDININ,KOND,KOND01,0,17,34,51
NSW,KOOTINGAL,KOOT,KOOT01,274,0,0,274
QLD,KOORALBYN,KORN,KORN01,135,0,0,135
NSW,KORORA,KORO,KORO01,498,0,0,498
VIC,KOROIT,KORT,KORT01,18,0,0,18
QLD,KOUMALA,KOUM,KOUM01,157,0,0,157
TAS,KOONYA,KOYA,KOYA01,164,0,0,164
NSW,KARUAH,KRAH,KRAH01,22,0,212,234
NSW,KRAMBACH,KRAM,KRAM01,0,0,0,0
VIC,KORUMBURRA,KRBA,KRBA01,112,0,355,467
NSW,KOORINGAL,KRGL,KRGL01,421,0,115,536
NSW,KARIONG,KRIG,KRIG01,49,0,0,49
NSW,KURRAJONG HEIGHTS,KRJH,KRJH01,0,0,163,163
QLD,KARALEE,KRLE,KRLE01,70,0,515,585
VIC,KOORLONG,KRLG,KRLG01,139,0,0,139
QLD,KURRIMINE BEACH,KRME,KRME01,0,0,0,0
VIC,KANGAROO GROUND,KROD,KROD01,263,0,0,263
QLD,KINGAROY,KROY,KROY01,289,0,0,289
SA,KARATTA,KRTA,KRTA01,0,0,59,59
SA,KERSBROOK,KSBK,KSBK01,119,0,0,119
WA,KINGSLEY,KSLY,KSLY01,459,0,6,465
NSW,KINGSVALE,KSVE,KSVE01,0,0,11,11
NSW,KATOOMBA,KTBA,KTBA01,2598,0,0,2598
NSW,KOORAWATHA,KTHA,KTHA01,156,0,0,156
NT,KATHERINE,KTHN,KTHN01,1521,0,0,1521
QLD,KINGSTHORPE,KTPE,KTPE01,407,0,0,407
VIC,KATUNGA,KUGA,KUGA01,120,0,0,120
NSW,KUNGALA,KULA,KULA01,145,0,0,145
WA,KULIN,KULI,KULI01,0,0,31,31
NSW,KULNURA,KULN,KULN01,0,28,0,28
QLD,KUMBIA,KUMB,KUMB01,167,0,0,167
NSW,KUNAMA,BATL,KUNA01,0,0,0,0
NSW,KUNDABUNG,KUND,KUND01,0,42,0,42
NSW,KUNGHUR,KUNG,KUNG01,0,32,0,32
QLD,KURANDA,KURA,KURA01,360,0,0,360
NSW,KURRAJONG,KURG,KURG01,4,0,397,401
NSW,KURNELL,KURN,KURN01,178,0,255,433
QLD,KUTTABUL,KUTT,KUTT01,144,0,0,144
QLD,KENTVILLE,KVLE,KVLE01,172,0,0,172
NSW,KELLYVILLE EAST,KELL,KVST01,3322,0,298,3620
VIC,KONGWAK,KWAK,KWAK01,155,0,0,155
NT,CASUARINA KWINANA COURT,CSUF,KWNT01,743,0,0,743
VIC,KILLAWARRA,KWRA,KWRA01,124,0,0,124
VIC,KOO WEE RUP,KWRP,KWRP01,63,0,0,63
VIC,KYABRAM,KYAB,KYAB01,687,0,249,936
VIC,KYNETON,KYNE,KYNE01,894,0,318,1212
VIC,KOOYONG,KYNG,KYNG01,3,1,0,4
NSW,KYOGLE,KYOG,KYOG01,67,0,0,67
TAS,LAUDERDALE,LADE,LADE01,376,0,384,760
NSW,LADYSMITH,LADY,LADY01,0,127,0,127
NSW,LAGUNA,LAGA,LAGA01,0,0,0,0
QLD,LAGOON POCKET,LAGO,LAGO01,323,0,0,323
QLD,LAIDLEY,LAID,LAID01,532,0,0,532
NSW,LAKEMBA,LAKE,LAKE01,528,0,127,655
QLD,LAMMERMOOR,LAMM,LAMM01,559,0,0,559
VIC,LAHARUM NORTH,LAMN,LAMN01,0,0,5,5
WA,LANCELIN,LANC,LANC01,263,0,0,263
QLD,LANDSBOROUGH,LAND,LAND01,16,0,0,16
NSW,LANE COVE,LANE,LANE01,342,0,0,342
VIC,LANCEFIELD,LANF,LANF01,147,0,0,147
VIC,LANCE CREEK,LANK,LANK01,0,0,0,0
NSW,LANSDOWNE,LANS,LANS01,134,0,0,134
VIC,LANGLEY,LANY,LANY01,0,0,18,18
VIC,LARA,LARA,LARA01,466,0,322,788
NT,LARAPINTA,LARP,LARP01,601,0,0,601
QLD,LAURA,CRSP,LAUR01,0,0,0,0
NSW,LAVINGTON,LAVN,LAVN01,2847,0,433,3280
VIC,LANGWARRIN,KALG,LAWN02,1488,0,0,1488
VIC,LAKE BOGA,LBGA,LBGA01,91,0,0,91
VIC,LETHBRIDGE,LBGE,LBGE01,33,0,0,33
QLD,LOWER BEECHMONT,LBMT,LBMT01,53,0,0,53
VIC,LAKE BOLAC,LBOC,LBOC01,0,0,0,0
NSW,LAKE CATHIE,LCAT,LCAT01,14,0,71,85
NSW,LAKE CARGELLIGO,LCGO,LCGO01,0,0,0,0
QLD,LUTWYCHE,LCHE,LCHE01,196,0,0,196
NSW,LOCKHART,LCKT,LCKT01,262,0,0,262
QLD,LAKE CLARENDON,LCLA,LCLA01,225,0,0,225
WA,LANDSDALE,LDLE,LDLE01,1490,0,0,1490
WA,LEEMAN,LEAN,LEAN01,343,0,0,343
TAS,LEGANA,LEGA,LEGA01,980,0,15,995
WA,LEINSTER,LEIN,LEIN01,211,0,0,211
VIC,LEITCHVILLE,LEIT,LEIT01,267,0,0,267
VIC,LEMNOS,LEMN,LEMN01,159,0,0,159
VIC,LAKES ENTRANCE,LENT,LENT01,487,0,291,778
NSW,LENNOX HEAD,LENX,LENX01,0,0,0,0
VIC,LEONGATHA,LEOG,LEOG01,910,0,123,1033
WA,LEONORA,LEON,LEON01,18,0,0,18
VIC,LEOPOLD,LEOP,LEOP01,1664,0,722,2386
NSW,LEPPINGTON,LEPP,LEPP01,150,252,200,602
NSW,LEURA,LERA,LERA01,1201,0,0,1201
WA,LESMURDIE,LESM,LESM01,64,0,1,65
VIC,LEXTON,LEXN,LEXN01,0,0,0,0
SA,LANGHORNE CREEK,LGCK,LGCK01,0,82,0,82
TAS,LONGFORD,LGFD,LGFD01,267,0,0,267
VIC,LANG LANG,LGLG,LGLG01,318,0,0,318
WA,LAKE GRACE,LGRA,LGRA01,0,0,0,0
NSW,LIDCOMBE,LIDC,LIDC01,238,0,0,238
TAS,LILYDALE,LIDE,LIDE01,269,0,0,269
VIC,LILYDALE,LILY,LILY01,258,0,0,258
NSW,LIMEKILNS,LIMK,LIMK01,0,0,0,0
NSW,LINDFIELD,LIND,LIND01,307,0,0,307
TAS,LINDISFARNE,LINE,LINE01,2177,0,0,2177
VIC,LINTON,LINT,LINT01,324,0,0,324
VIC,LINDENOW,LINW,LINW01,271,0,0,271
NSW,LISMORE,LISM,LISM01,704,0,402,1106
SA,LIPSON,LISN,LISN01,0,0,32,32
NSW,LIGHTNING RIDGE,LITE,LITE01,36,0,160,196
NSW,LITHGOW,LITH,LITH01,1,0,552,553
VIC,LITTLE RIVER,LITL,LITL01,45,0,0,45
NSW,LIVERPOOL,LIVE,LIVE01,258,0,189,447
NSW,LONG JETTY,LJTY,LJTY01,4237,0,0,4237
NSW,LAKESLAND,LKLD,LKLD01,160,0,0,160
NSW,LAKE MUNMORAH,LKMA,LKMA01,1330,0,72,1402
VIC,LOCKINGTON,LKTN,LKTN01,289,0,0,289
VIC,LLANELLY,LLAN,LLAN01,135,0,0,135
NSW,LLANDILO,LLDO,LLDO01,88,0,0,88
NSW,LOOMBERAH,LMBH,LMBH01,0,0,0,0
SA,LAMEROO,LMRO,LMRO01,205,0,0,205
VIC,LEARMONTH,LMTH,LMTH01,0,0,0,0
NSW,LINDEN,LNDN,LNDN01,34,0,0,34
VIC,LEONARDS HILL,LNDS,LNDS01,0,14,0,14
VIC,LAUNCHING PLACE,LNGE,LNGE01,86,0,0,86
QLD,LOGANHOLME,LNHE,LNHE01,5,0,0,5
NSW,LILLIAN ROCK,LNRK,LNRK01,0,0,0,0
ACT,LANYON,LNYN,LNYN01,262,0,0,262
SA,LOBETHAL,LOBL,LOBL01,21,0,0,21
VIC,LOCKWOOD,LOCD,LOCD01,174,0,0,174
VIC,LOCH,LOCH,LOCH01,0,95,0,95
SA,LOCK,LOCK,LOCK01,133,0,0,133
TAS,LONGLEY,LOEY,LOEY01,238,0,0,238
QLD,LOGAN VILLAGE,LOGA,LOGA01,472,0,401,873
VIC,LONSDALE,LONS,LONS01,872,0,0,872
VIC,LONGWOOD,LOOD,LOOD01,170,0,0,170
VIC,LONGFORD,LORD,LORD01,294,0,0,294
VIC,LORNE,LORN,LORN01,178,0,235,413
VIC,LONGWARRY,LORY,LORY01,330,0,0,330
NSW,LOWESDALE,LOWE,LOWE01,0,0,0,0
QLD,LOWOOD,LOWO,LOWO01,534,54,0,588
NSW,LOWER PORTLAND,LPTD,LPTD01,25,0,0,25
NSW,LAWRENCE,LRCE,LRCE01,147,0,0,147
QLD,LONGREACH,LRCH,LRCH01,0,0,259,259
NSW,LARGS,LRGS,LRGS01,815,0,175,990
NSW,LORNE,LRNE,LRNE01,29,0,0,29
NSW,LAURIETON,LRTN,LRTN01,797,0,0,797
QLD,LOWER TULLY,LRTU,LRTU01,326,0,0,326
SA,LONSDALE,LSDE,LSDE01,3223,0,207,3430
VIC,LOCH SPORT,LSPT,LSPT01,97,0,0,97
VIC,LISMORE,LSRE,LSRE01,0,0,0,0
SA,LENSWOOD,LSWD,LSWD01,39,0,0,39
TAS,LATROBE,LTBE,LTBE01,460,0,0,460
WA,LITTLE GROVE,LTLG,LTLG01,315,0,0,315
NSW,LEETON,LTON,LTON01,777,0,271,1048
VIC,LAVERTON,LTVN,LTVN01,397,0,0,397
QLD,LUCINDA,LUCI,LUCI01,0,111,0,111
NSW,LUDDENHAM,LUDM,LUDM01,136,0,0,136
SA,LUCINDALE,LULE,LULE01,0,106,0,106
SA,LAURA,LURA,LURA01,270,0,0,270
NSW,LOCHINVAR,LVAR,LVAR01,251,0,0,251
VIC,LAVERTON SOUTH,LVSX,LVSX01,1,0,0,1
WA,LAVERTON,LVTN,LVTN01,89,0,0,89
WA,LOWER CHITTERING,LWCH,LWCH01,70,0,0,70
NSW,LAWSON,LWSN,LWSN01,691,0,382,1073
SA,LOXTON NORTH,LXNN,LXNN01,120,0,0,120
SA,LOXTON,LXTN,LXTN01,708,0,0,708
SA,LYNDOCH,LYDH,LYDH01,100,0,157,257
VIC,LYSTERFIELD,LYFD,LYFD01,455,0,0,455
NSW,LYNDHURST,LYND,LYND01,145,0,0,145
VIC,LYNDHURST,LYNH,LYNH01,1896,0,356,2252
TAS,LYMWOOD,LYOD,LYOD01,168,0,0,168
NSW,MALUA BAY,MABY,MABY01,61,0,490,551
QLD,MENA CREEK,MACK,MACK01,80,0,0,80
NSW,MACKSVILLE,MACS,MACS01,388,0,0,388
WA,MADDINGTON,MADD,MADD01,470,0,276,746
WA,MANDURAH NORTH,MADN,MADN01,1514,0,0,1514
WA,MANDURAH SOUTH,MADS,MADS01,1196,0,154,1350
VIC,MAFFRA,MAFF,MAFF01,432,0,316,748
TAS,MARGATE,MAGE,MAGE01,371,0,0,371
QLD,MAGNETIC ISLAND,MAGN,MAGN01,56,0,0,56
NSW,MAIN ARM,MAIA,MAIA01,22,0,0,22
VIC,MAIDEN GULLY,MAID,MAID01,316,0,0,316
VIC,MAIN RIDGE,MAIR,MAIR01,94,0,0,94
NSW,MAITLAND,MAIT,MAIT01,2800,0,121,2921
VIC,MAJORCA,MAJO,MAJO01,330,0,0,330
QLD,MALANDA,MALA,MALA01,370,0,0,370
VIC,MALDON,MALD,MALD01,123,0,0,123
SA,MALLALA,MALL,MALL01,209,0,0,209
VIC,MALMSBURY,MALM,MALM01,323,0,0,323
VIC,MALVERN,MALV,MALV01,0,0,144,144
QLD,MALENY,MALY,MALY01,30,0,0,30
NSW,MAITLAND METFORD HUT,MAIT,MAMK01,662,0,306,968
NSW,MANILLA,MANI,MANI01,458,0,0,458
NSW,MANLY,MANL,MANL01,2,0,357,359
NSW,MANAR,MANR,MANR01,0,0,39,39
VIC,MANANGATANG,MANT,MANT01,0,30,0,30
VIC,MELBOURNE AIRPORT,TMNE,MAPM01,0,0,51,51
NSW,MARRAR,MARA,MARA01,0,0,0,0
VIC,MARONG,MARG,MARG01,125,0,0,125
NSW,MARCH,MARH,MARH01,316,0,0,316
VIC,MARLO,MARL,MARL01,0,0,0,0
NSW,MAROUBRA,MARO,MARO01,554,0,0,554
QLD,MAROOCHY RIVER,MARR,MARR01,224,0,0,224
VIC,MARYSVILLE,MARS,MARS01,156,0,0,156
QLD,MARYVALE,MARV,MARV01,65,0,0,65
VIC,MARYBOROUGH,MARY,MARY01,139,0,46,185
NSW,MASCOT,MASC,MASC01,765,0,0,765
NSW,MATHOURA,MATH,MATH01,69,0,0,69
NSW,MATRAVILLE,MATR,MATR01,409,0,264,673
VIC,MAUDE,MAUD,MAUD01,120,0,0,120
VIC,MACARTHUR,MAUR,MAUR01,0,0,0,0
NSW,MAYFIELD,MAYF,MAYF01,1643,0,2257,3900
WA,MAYLANDS,MAYM,MAYM01,0,0,0,0
NSW,MURWILLUMBAH,MBAH,MBAH01,336,0,54,390
WA,MOUNT BARKER,MBAR,MBAR01,369,0,0,369
VIC,MURRABIT,MBIT,MBIT01,0,0,0,0
WA,MOUNT BEAUMONT,MBMT,MBMT01,0,0,23,23
QLD,MARYBOROUGH,MBOR,MBOR01,496,0,0,496
QLD,MUNDUBBERA,MBRA,MBRA01,99,0,0,99
NSW,MULBRING,MBRG,MBRG01,0,1,0,1
NSW,MURRUMBATEMAN,MBTN,MBTN01,102,0,0,102
VIC,MCEVOYS,MCEV,MCEV01,172,0,0,172
SA,MACCLESFIELD,MCFD,MCFD01,386,0,0,386
SA,MCLAREN FLAT,MCFT,MCFT01,181,0,0,181
NSW,MICHELAGO,MCGO,MCGO01,0,65,0,65
NSW,MCCULLYS GAP,MCGP,MCGP01,0,0,0,0
QLD,MITCHELTON,MCHN,MCHN01,645,0,0,645
VIC,MC IVOR ROAD,BEND,MCIV01,461,148,374,983
QLD,MACLEAY ISLAND,MCLI,MCLI01,4,0,0,4
NSW,MACLEAN,MCLN,MCLN01,28,1,327,356
VIC,MALLACOOTA,MCTA,MCTA01,0,0,0,0
QLD,MERINGANDAN,MDAN,MDAN01,40,0,0,40
SA,MODBURY,MDBY,MDBY01,1170,0,0,1170
NSW,MULLAMUDDY,MDDY,MDDY01,137,0,0,137
QLD,MINDEN,MDEN,MDEN01,157,0,0,157
QLD,MULGILDIE,MDIE,MDIE01,0,0,0,0
WA,MERREDIN,MDIN,MDIN01,164,0,0,164
WA,MUNDIJONG,MDJG,MDJG01,35,0,0,35
WA,MIDLAND,MDLD,MDLD01,1078,0,496,1574
WA,MAIDA VALE,MDLE,MDLE01,1515,0,254,1769
WA,MEDINA,MDNA,MDNA01,1374,0,676,2050
WA,MUNDARING,MDNG,MDNG01,19,0,593,612
WA,MANDURAH,MDRA,MDRA01,3492,0,433,3925
VIC,MAIDSTONE,MDST,MDST01,30,0,1362,1392
NSW,MEDLOW BATH,MDWB,MDWB01,0,130,0,130
NSW,MEDOWIE,MDWI,MDWI01,148,0,0,148
SA,MEADOWS,MDWS,MDWS01,177,0,0,177
QLD,MEANDARRA,MEAN,MEAN01,342,0,0,342
QLD,MAREEBA,MEBA,MEBA01,214,0,0,214
TAS,MOLE CREEK,MECK,MECK01,141,0,0,141
WA,MEEKATHARRA,MEEK,MEEK01,33,0,0,33
NSW,MEGALONG,BLKH,MEGA01,49,0,0,49
NSW,MEGAN,MEGN,MEGN01,0,0,13,13
NSW,MENAI,MENA,MENA01,562,0,0,562
NSW,MENDOORAN,MEND,MEND01,0,37,0,37
NSW,MENINDEE,MENE,MENE01,79,0,0,79
VIC,MERBEIN,MERB,MERB01,89,0,0,89
NSW,MEREWETHER,MERE,MERE01,3718,0,0,3718
VIC,MEREDITH,MERH,MERH01,0,10,0,10
NSW,MERIMBULA,MERI,MERI01,301,0,0,301
NSW,MEROO MEADOW,MERM,MERM01,0,0,67,67
VIC,MERBEIN SOUTH,METH,METH01,230,0,0,230
WA,MULLEWA,MEWA,MEWA01,107,0,0,107
VIC,MANSFIELD,MFLD,MFLD01,67,0,346,413
QLD,MUNGAR,MGAR,MGAR01,235,0,0,235
QLD,MOUNT GRAVATT,MGAT,MGAT01,437,0,726,1163
QLD,MUDGEERABA,MGBA,MGBA01,1231,0,0,1231
SA,MINGBOOL,MGBL,MGBL01,0,0,11,11
NSW,MUNGINDI,MGDI,MGDI01,221,0,0,221
SA,MENINGIE,MGIE,MGIE01,305,0,0,305
NSW,MENANGLE,MGLE,MGLE01,46,0,0,46
QLD,MOUNT GARNET,MGNT,MGNT01,159,0,0,159
WA,MINGENEW,MGNU,MGNU01,111,0,0,111
NSW,MULGOA,MGOA,MGOA01,451,0,0,451
NSW,MANNERING PARK,MGPK,MGPK01,531,0,256,787
QLD,MIDGE POINT,MGPT,MGPT01,161,0,0,161
VIC,MERRIGUM,MGUM,MGUM01,264,0,0,264
WA,MOUNT HAWTHORN,MHAW,MHAW01,4,0,2103,2107
NSW,MOUNT HUNTER,MHTR,MHTR01,27,0,0,27
QLD,MIALLO,MIAL,MIAL01,175,0,0,175
QLD,MARIAN,MIAN,MIAN01,390,0,0,390
QLD,MISSION BEACH,MIBH,MIBH01,216,0,39,255
SA,MILLICENT,MICT,MICT01,68,88,0,156
QLD,MIDDLE RIDGE,MIDD,MIDD01,4428,0,0,4428
NT,MILINGIMBI,MGRP,MIGX01,113,0,0,113
VIC,MILDURA,MILD,MILD01,347,0,0,347
NSW,MILLER,MILL,MILL01,406,0,2676,3082
NSW,MILLTHORPE,MILP,MILP01,0,209,0,209
NT,PETERMANN MIMILI,PETN,MIML01,0,0,0,0
QLD,MIDDLEMOUNT,MIMN,MIMN01,514,0,0,514
NSW,MINNAMURRA,MINA,MINA01,381,758,0,1139
SA,MINLATON,MINL,MINL01,175,0,0,175
NSW,MINTO,MINT,MINT01,569,0,0,569
VIC,MINYIP,MINY,MINY01,0,0,0,0
TAS,MIDDLETON,MION,MION01,146,0,0,146
NSW,MIRANDA,MIRA,MIRA01,147,0,637,784
QLD,MIRIAM VALE,MIRI,MIRI01,237,0,0,237
VIC,MIRBOO NORTH,MIRN,MIRN01,169,204,129,502
QLD,MISSION BEACH SOUTH,MISS,MISS01,366,0,0,366
QLD,MITCHELL,MITC,MITC01,0,0,0,0
NSW,MITTAGONG,MITG,MITG01,1418,0,0,1418
NSW,MITCHELLS ISLAND,MITI,MITI01,137,0,0,137
VIC,MITCHAM,MITM,MITM01,95,0,2093,2188
WA,MANJIMUP,MJMP,MJMP01,584,0,305,889
WA,MANJIMUP WEST,MJMW,MJMW01,0,0,0,0
QLD,MACKAY,MKAY,MKAY01,2214,0,0,2214
QLD,MILLAA MILLAA,MLAA,MLAA01,0,0,0,0
ACT,MELBA,MLBA,MLBA01,32,0,2,34
VIC,MORDIALLOC SOUTH,MLOC,MLCS02,5,0,143,148
QLD,MILES,MLES,MLES01,25,0,0,25
WA,MORLEY,MLEY,MLEY01,0,0,2691,2691
NSW,MALLANGANEE,MLGE,MLGE01,0,0,0,0
NSW,MOULAMEIN,MLMN,MLMN01,0,58,0,58
VIC,MORELAND,MLND,MLND01,297,0,0,297
SA,MILANG,MLNG,MLNG01,278,0,0,278
VIC,MORDIALLOC,MLOC,MLOC01,2,0,1284,1286
VIC,MELTON,MLON,MLON01,1192,0,0,1192
WA,MULLALOO,MLOO,MLOO01,685,0,2212,2897
QLD,MAUDSLAND,MLSD,MLSD01,463,0,0,463
SA,MELROSE,MLSE,MLSE01,138,0,0,138
WA,MYALUP,MLUP,MLUP01,274,0,0,274
ACT,WODEN REMOTE MDF,DKIN,MLUV01,241,0,0,241
NSW,MILVALE,MLVL,MLVL01,0,0,0,0
VIC,MILAWA,MLWA,MLWA01,294,0,0,294
WA,MALAGA,BLJA,MLZX01,0,0,188,188
WA,MOUNT MAGNET,MMAG,MMAG01,264,0,0,264
VIC,MCMAHONS CREEK,MMHK,MMHK01,118,0,0,118
QLD,MILLMERRAN,MMRN,MMRN01,0,0,0,0
NSW,MOONEBA,MNBA,MNBA01,127,0,0,127
QLD,MORANBAH,MNBH,MNBH01,1803,0,0,1803
QLD,MOUNT NEBO,MNBO,MNBO01,16,0,0,16
WA,MINDARIE,MNDE,MNDE01,511,0,530,1041
NSW,MANILDRA,MNDR,MNDR01,258,0,0,258
NSW,MOONAN FLAT,MNFT,MNFT01,0,0,0,0
NT,MANINGRIDA,MNGA,MNGA01,298,0,0,298
NT,ARNHEM WEST MINJILANG,ARNW,MNJG01,118,0,0,118
ACT,MANUKA,MNKA,MNKA01,24,0,222,246
WA,MANNING,MNNG,MNNG01,1354,0,0,1354
SA,MANNUM,MNNM,MNNM01,193,0,0,193
NSW,MCMAHONS REEF,MNRF,MNRF01,0,0,15,15
SA,MONARTO,MNRT,MNRT01,0,10,0,10
ACT,MONASH,MNSH,MNSH01,204,0,0,204
SA,MOONTA,MNTA,MNTA01,444,403,0,847
QLD,MONTO,MNTO,MNTO01,0,0,0,0
SA,MCLAREN VALE,MNVE,MNVE01,570,0,610,1180
VIC,MEENIYAN,MNYN,MNYN01,280,0,0,280
VIC,MOAMA,ECHU,MOAM01,941,0,0,941
TAS,MOWBRAY,MOAY,MOAY01,1480,0,454,1934
NSW,MOOBALL,MOBL,MOBL01,204,0,0,204
NSW,MODANVILLE,MODE,MODE01,246,0,0,246
VIC,MOE,MOEE,MOEE01,2287,0,337,2624
QLD,MOGGILL,MOGG,MOGG01,1544,0,14,1558
WA,MOONYOONOOKA,MOKA,MOKA01,358,0,0,358
NSW,MOLONG,MOLG,MOLG01,451,0,0,451
QLD,MOLLOY,MOLL,MOLL01,0,0,0,0
VIC,MOOLAP,MOLP,MOLP01,429,0,0,429
TAS,MOLTEMA,MOMA,MOMA01,155,0,0,155
NSW,MONA VALE,MONA,MONA01,51,0,313,364
VIC,MONBULK,MONB,MONB01,3,0,318,321
QLD,MONA PARK,MONP,MONP01,0,0,15,15
QLD,MONTVILLE,MONV,MONV01,145,0,0,145
VIC,MOORABOOL,MOOB,MOOB01,119,0,0,119
VIC,MOOROODUC,MOOD,MOOD01,58,0,0,58
QLD,MOOLOOLABA,MOOH,MOOH01,5910,0,0,5910
QLD,MOOLOOLAH,MOOL,MOOL01,220,0,269,489
NSW,MOONEY MOONEY,MOON,MOON01,196,0,0,196
VIC,MOOROOPNA,MOOP,MOOP01,1484,0,611,2095
WA,MOORA,MORA,MORA01,141,0,0,141
VIC,MORIAC,MORI,MORI01,51,0,0,51
VIC,MOOROOLBARK,MORK,MORK01,479,0,5,484
VIC,MORNINGTON,MORN,MORN01,4546,0,296,4842
NSW,MORUYA,MORU,MORU01,300,0,299,599
SA,MONASH,MOSH,MOSH01,288,0,0,288
NSW,MOSMAN,MOSM,MOSM01,324,0,2213,2537
NSW,MOSSY POINT,MOSP,MOSP01,343,0,0,343
QLD,MOSSMAN,MOSS,MOSS01,83,0,0,83
QLD,MOTHAR MOUNTAIN,MOTH,MOTH01,0,88,0,88
QLD,MOURA,MOUR,MOUR01,248,0,0,248
WA,MORAWA,MOWA,MOWA01,250,0,0,250
VIC,MOYHU,MOYU,MOYU01,0,109,0,109
SA,MYPOLONGA,MPGA,MPGA01,156,0,0,156
NSW,MARPLE,MPLE,MPLE01,0,0,0,0
QLD,MURPHYS CREEK,MPYC,MPYC01,0,0,0,0
QLD,MERRIMAC,MRAC,MRAC01,385,0,2147,2532
SA,MACGILLIVRAY,MRAY,MRAY01,0,0,0,0
QLD,MARBURG,MRBG,MRBG01,14,0,0,14
NSW,MOOR CREEK,MRCK,MRCK01,246,0,0,246
VIC,MERNDA,MRDA,MRDA01,622,0,0,622
NSW,MURRURUNDI,MRDI,MRDI01,0,20,47,67
QLD,MARSDEN,MRDN,MRDN01,188,0,0,188
NSW,MOREE,MREE,MREE01,43,0,0,43
QLD,MORAYFIELD,MRFD,MRFD01,273,0,0,273
SA,MORGAN,MRGN,MRGN01,0,0,0,0
WA,MARGARET RIVER,MRGR,MRGR01,393,0,300,693
NSW,MOORLAND,MRLD,MRLD01,0,84,0,84
NSW,MARLEE,MRLE,MRLE01,0,42,0,42
NSW,MARULAN,MRLN,MRLN01,119,0,0,119
VIC,MORTLAKE,MRLT,MRLT01,181,0,0,181
QLD,MIRANI,MRNI,MRNI01,450,0,0,450
VIC,MERINO,MRNO,MRNO01,118,0,0,118
VIC,MERRICKS NORTH,MRRN,MRRN01,129,0,0,129
NSW,MORISSET,MRSE,MRSE01,1717,0,749,2466
VIC,MINERS REST,MRST,MRST01,44,0,0,44
NSW,MAROOTA,MRTA,MRTA01,0,51,0,51
NSW,MAROOTA SOUTH,MRTS,MRTS01,127,0,0,127
QLD,MORVEN,MRVN,MRVN01,0,59,0,59
NSW,MERRIWA,MRWA,MRWA01,249,0,0,249
NSW,MARAYLYA,MRYA,MRYA01,224,0,0,224
WA,MEADOW SPRINGS,MSPS,MSPS01,630,0,526,1156
VIC,MILDURA SOUTH,MILD,MSRC01,102,0,43,145
NSW,MOSS VALE,MSVE,MSVE01,1329,0,521,1850
QLD,MOUNT ALFORD,MTAL,MTAL01,133,0,0,133
QLD,MOUNT ARCHER,MTAR,MTAR01,110,0,0,110
QLD,MOUNT ABBOT,MTAT,MTAT01,140,0,0,140
SA,MOUNT BARKER,MTBK,MTBK01,1320,0,765,2085
VIC,MOUNT BULLER,MTBL,MTBL01,133,0,0,133
SA,MOUNT BURR,MTBR,MTBR01,117,0,0,117
VIC,MOUNT BEAUTY,MTBY,MTBY01,74,0,0,74
VIC,MOUNT CLEAR,MTCA,MTCA01,899,0,0,899
NSW,MYRTLE CREEK,MTCK,MTCK01,0,0,0,0
VIC,MOUNT COTTRELL,MTCO,MTCO01,265,0,0,265
SA,MOUNT COMPASS,MTCS,MTCS01,167,0,0,167
QLD,MOUNT CROSBY,MTCY,MTCY01,26,0,550,576
VIC,MOUNT DUNEED,MTDU,MTDU01,143,0,0,143
VIC,MOUNT ELIZA,MTEA,MTEA01,3356,0,0,3356
VIC,MOUNT EVELYN,MTEN,MTEN01,16,0,90,106
SA,MOUNT GAMBIER,MTGE,MTGE01,2675,0,0,2675
NSW,MOUNT GEORGE,MTGF,MTGF01,0,55,0,55
QLD,MOUNT GLORIOUS,MTGS,MTGS01,24,0,0,24
VIC,MOUNT MARTHA,MTHA,MTHA01,1469,0,817,2286
NSW,MOUNT HUTTON,MTHN,MTHN01,2968,0,927,3895
QLD,MOUNT ISA,MTIF,MTIF01,402,0,0,402
SA,MOUNT JAGGED,MTJD,MTJD01,0,0,0,0
QLD,MOUNT KILCOY,MTKI,MTKI01,100,0,0,100
NSW,MOUNT KURING-GAI,MTKU,MTKU01,1,0,573,574
QLD,MOUNT LARCOM,MTLA,MTLA01,114,0,0,114
SA,MAITLAND,MTLD,MTLD01,138,0,0,138
QLD,MOUNT LOW,MTLW,MTLW01,1300,286,0,1586
QLD,MOUNT MEE,MTME,MTME01,192,0,0,192
VIC,MOUNT MACEDON,MTMN,MTMN01,0,0,359,359
QLD,MOUNT MORGAN,MTMO,MTMO01,407,0,0,407
WA,MOUNT HELENA,MTNA,MTNA01,43,0,0,43
TAS,MOUNT NELSON,DAEY,MTNN01,586,0,0,586
QLD,MOUNT PERRY,MTPR,MTPR01,0,55,0,55
SA,MOUNT PLEASANT,MTPT,MTPT01,0,0,200,200
VIC,MONTROSE,MTRE,MTRE01,289,0,86,375
SA,MINTARO,MTRO,MTRO01,0,0,0,0
SA,MOUNT SCHANK,MTSK,MTSK01,0,0,0,0
QLD,MOUNT SYLVIA,MTSY,MTSY01,0,0,0,0
QLD,MOUNT TARAMPA,MTTA,MTTA01,59,0,0,59
SA,MOUNT TORRENS,MTTS,MTTS01,13,0,0,13
SA,MORPHETT VALE EAST,MTVX,MTVX01,605,0,239,844
NSW,MOUNT WILSON,MTWN,MTWN01,42,0,0,42
WA,MUCHEA,MUCH,MUCH01,276,0,0,276
NSW,MUDGEE,MUDG,MUDG01,1408,0,423,1831
QLD,MUDJIMBA,MUDJ,MUDJ01,135,0,581,716
WA,MUKINBUDIN,MUKA,MUKA01,0,0,0,0
NSW,MULLUMBIMBY,MULL,MULL01,1,0,357,358
VIC,METUNG,MUNG,MUNG01,58,0,0,58
WA,MUNSTER,MUNS,MUNS01,348,0,69,417
VIC,MURCHISON,MURC,MURC01,314,0,0,314
QLD,MURGON,MURG,MURG01,22,0,0,22
VIC,MURTOA,MURT,MURT01,335,0,0,335
VIC,MURRAYVILLE,MURV,MURV01,0,82,0,82
NSW,MUSWELLBROOK,MUSL,MUSL01,804,0,263,1067
QLD,MUTTABURRA,MUTT,MUTT01,0,0,0,0
WA,MUNSTER HENDERSON OP MDF,MUNS,MVHE01,336,0,0,336
NSW,MOUNT VICTORIA,MVIC,MVIC01,314,0,0,314
TAS,MOOREVILLE,MVLE,MVLE01,488,0,0,488
NSW,MANGROVE MOUNTAIN,MVMT,MVMT01,0,0,0,0
VIC,MORWELL,MWRL,MWRL01,1637,0,307,1944
ACT,MAWSON,MWSN,MWSN01,974,0,457,1431
NSW,MOUNT WHITE,MWTE,MWTE01,0,54,0,54
VIC,MOLYULLAH,MYAH,MYAH01,138,0,0,138
QLD,MOURILYAN,MYAN,MYAN01,0,196,0,196
SA,MURRAY BRIDGE,MYBE,MYBE01,1920,0,576,2496
QLD,MAROOCHYDORE,MYDE,MYDE01,3246,0,1422,4668
VIC,MYRTLEFORD,MYFD,MYFD01,178,0,0,178
SA,MYLOR,MYLR,MYLR01,0,0,0,0
SA,MYPONGA,MYPA,MYPA01,38,0,0,38
VIC,MYRNIONG,MYRN,MYRN01,0,48,0,48
QLD,MURRAY UPPER,MYUP,MYUP01,165,0,0,165
NT,MARYVALE COMMUNITY,RODG,MYVR01,96,0,0,96
NSW,NARARA,NAAA,NAAA01,1676,661,540,2877
NSW,NABIAC,NABI,NABI01,219,0,0,219
VIC,NAGAMBIE,NAGB,NAGB01,73,0,0,73
VIC,NARINGAL EAST,NAGE,NAGE01,0,22,0,22
NSW,NANA GLEN,NAGN,NAGN01,229,0,0,229
SA,NORTH ADELAIDE,NALE,NALE01,57,0,673,730
NSW,NAMBUCCA HEADS,NAMH,NAMH01,222,0,0,222
QLD,NANANGO,NANA,NANA01,108,0,0,108
VIC,NAPOLEONS,NAPO,NAPO01,0,263,9,272
VIC,NIRRANDA,NARD,NARD01,165,0,0,165
QLD,NARKUNDA,NARK,NARK01,0,0,0,0
NSW,NORTH ARM COVE,NARM,NARM01,117,0,0,117
VIC,NARRE WARREN NORTH,NARN,NARN01,211,0,0,211
NSW,NARRABEEN,NARR,NARR01,18,0,455,473
SA,NARACOORTE,NATE,NATE01,447,0,37,484
VIC,NATHALIA,NATH,NATH01,335,0,0,335
VIC,NATIMUK,NATI,NATI01,0,0,0,0
QLD,NATURAL BRIDGE,NATU,NATU01,0,0,0,0
VIC,NARRE WARREN,NAWN,NAWN01,1184,0,2416,3600
VIC,NORTH BALWYN,NBAL,NBAL01,105,0,415,520
VIC,NARBETHONG,NBNG,NBNG01,130,0,0,130
NSW,NORTHBRIDGE,NBRI,NBRI01,627,0,0,627
NSW,NARRABRI,NBRR,NBRR01,105,0,0,105
QLD,NAMBOUR,NBUR,NBUR01,2983,0,0,2983
WA,NORTHCLIFFE,NCLF,NCLF01,269,0,0,269
VIC,NORTHCOTE,NCOE,NCOE01,341,0,0,341
QLD,NUNDAH,NDAH,NDAH01,54,0,0,54
WA,NORTH DANDALUP,NDAN,NDAN01,92,0,0,92
QLD,NUDGEE,NDGE,NDGE01,77,0,439,516
WA,NEDLANDS,NDLN,NDLN01,267,0,0,267
NSW,NARRANDERA,NDRA,NDRA01,589,0,320,909
VIC,NARRE WARREN SOUTH,NAWN,NDSH01,2438,0,0,2438
QLD,NEBO,NEBO,NEBO01,0,44,0,44
VIC,NEERIM JUNCTION,NEEJ,NEEJ01,0,90,0,90
NSW,NERRIGA,NEGA,NEGA01,0,0,0,0
NSW,NELLIGEN,NELL,NELL01,0,87,0,87
NSW,NEMINGHA,NEMG,NEMG01,202,0,0,202
QLD,NERANG,NERG,NERG01,354,0,619,973
VIC,NELSON,NESN,NESN01,326,0,0,326
VIC,NORTH ESSENDON,NESS,NESS01,141,0,0,141
WA,NEWDEGATE,NEWD,NEWD01,0,108,0,108
VIC,NEWHAVEN,NEWH,NEWH01,776,0,0,776
QLD,NEWTOWN,NEWO,NEWO01,4001,0,479,4480
VIC,NEWSTEAD,NEWS,NEWS01,272,0,0,272
NSW,NEWTOWN,NEWT,NEWT01,669,0,1502,2171
WA,JIMBLEBAR VILLAGE,NWMN,NFJR01,0,0,0,0
QLD,MOLLOY CA001,MOLL,NFPM01,0,0,0,0
WA,NULLAGINE,NGIN,NGIN01,0,78,0,78
VIC,NORTH GEELONG,NGLG,NGLG01,460,0,0,460
QLD,NORTH GOOBURRUM,NGOO,NGOO01,136,0,0,136
SA,NANGWARRY,NGRY,NGRY01,0,131,0,131
NT,NGUKURR,ROPR,NGUK01,73,0,0,73
VIC,NHILL,NHIL,NHIL01,33,0,0,33
NSW,NORTH RICHMOND,NHRD,NHRD01,0,0,305,305
NSW,NIMBIN,NIMB,NIMB01,99,0,184,283
NSW,NIMMITABEL,NIMI,NIMI01,0,18,38,56
QLD,NINGI,NING,NING01,954,0,415,1369
NSW,NELSON BAY,NLBY,NLBY01,1861,0,400,2261
NT,NHULUNBUY,NLNF,NLNF01,865,0,0,865
VIC,NANGILOC,NLOC,NLOC01,0,0,0,0
NSW,NEW LAMBTON,NLTN,NLTN01,3756,0,0,3756
VIC,NEWLYN,NLYN,NLYN01,0,0,0,0
VIC,NORTH MELBOURNE,NMEL,NMEL01,0,0,0,0
QLD,NEWMARKET,NMKT,NMKT01,525,0,0,525
NSW,NARROMINE,NMNE,NMNE01,434,0,218,652
NT,NOONAMAH CORAL,NNMH,NNAT01,174,0,0,174
VIC,NAR NAR GOON NORTH,NNGN,NNGN01,95,0,0,95
VIC,NAR NAR GOON,NNGO,NNGO01,0,0,0,0
NT,NOONAMAH,NNMH,NNMH01,96,0,0,96
WA,NANNUP,NNUP,NNUP01,166,0,0,166
QLD,NOBBY,NOBB,NOBB01,155,0,0,155
TAS,NEW NORFOLK,NOLK,NOLK01,463,0,450,913
QLD,NOME,NOME,NOME01,306,0,0,306
VIC,NOORAT,NOOA,NOOA01,0,0,0,0
VIC,NOOJEE,NOOJ,NOOJ01,131,0,0,131
QLD,NOOSA HEADS,NOOS,NOOS01,1094,0,0,1094
QLD,NOOSAVILLE,NOOV,NOOV01,2229,0,210,2439
QLD,NORMANTON,NORM,NORM01,193,0,0,193
NSW,NORTH PARRAMATTA,NPAR,NPAR01,209,0,0,209
VIC,NEWPORT,NPRT,NPRT01,390,0,48,438
QLD,NARANGBA,NRBA,NRBA01,1232,0,0,1232
WA,NAREMBEEN,NRBN,NRBN01,227,0,0,227
WA,NEERABUP,NRBP,NRBP01,241,0,0,241
NSW,NORDS WHARF,NRDS,NRDS01,0,0,151,151
WA,NARROGIN,NRGN,NRGN01,847,0,221,1068
NSW,NARELLAN,NRLN,NRLN01,5110,0,0,5110
NSW,NAROOMA,NRMA,NRMA01,23,0,0,23
QLD,NORTH MACKAY,NRMK,NRMK01,2130,0,0,2130
VIC,NEERIM SOUTH,NRMS,NRMS01,71,0,0,71
SA,NAIRNE,NRNE,NRNE01,1298,0,0,1298
SA,NORWOOD,NRWD,NRWD01,0,0,260,260
NSW,NORTH RYDE,NRYD,NRYD01,1133,0,0,1133
WA,NORSEMAN,NSMN,NSMN01,289,0,0,289
NSW,NORTH SYDNEY,NSYD,NSYD01,706,0,2207,2913
NT,NIGHTCLIFF,NTCF,NTCF01,3241,30,229,3500
WA,NORTHAM,NTHC,NTHC01,692,0,57,749
WA,NORTHAMPTON,NTHH,NTHH01,0,94,0,94
VIC,NOTTING HILL,CLAY,NTHL02,0,0,0,0
NSW,NUMERALLA,NUME,NUME01,0,76,0,76
VIC,NUMURKAH,NUMU,NUMU01,390,0,0,390
TAS,NUBEENA,NUNA,NUNA01,319,0,0,319
NSW,NUNDLE,NUND,NUND01,0,126,0,126
SA,NURIOOTPA,NURI,NURI01,487,0,384,871
QLD,NEW FARM,NWFM,NWFM01,0,0,2050,2050
WA,NEWMAN,NWMN,NWMN01,11,0,0,11
NSW,NOWRA,NWRA,NWRA01,3264,0,464,3728
TAS,NEW TOWN,NWTN,NWTN01,3199,0,1486,4685
WA,NYABING,NYAB,NYAB01,164,0,0,164
VIC,NYAH,NYAH,NYAH01,35,0,0,35
NSW,NYMBOIDA,NYBA,NYBA01,121,0,0,121
NSW,NYNGAN,NYGN,NYGN01,156,0,0,156
VIC,NYORA,NYOR,NYOR01,101,0,0,101
TAS,OATLANDS,OADS,OADS01,144,0,0,144
NSW,OAKDALE,OAKE,OAKE01,126,0,0,126
VIC,OAKLEIGH,OAKL,OAKL01,112,0,2034,2146
NSW,THE OAKS,OAKS,OAKS01,441,0,0,441
NSW,OURIMBAH,OBAH,OBAH01,658,0,179,837
NSW,OLD BAR,OBAR,OBAR01,872,0,496,1368
SA,OB FLAT,OBFT,OBFT01,119,0,0,119
NSW,OBERON,OBON,OBON01,291,0,0,291
QLD,OCEAN VIEW,OCER,OCER01,58,0,0,58
VIC,OCEAN GROVE,OCGR,OCGR01,2273,0,934,3207
NSW,OCEAN SHORES,OCNS,OCNS01,0,0,3,3
WA,OCEAN REEF,OCRF,OCRF01,0,34,525,559
NT,ARNHEM WEST OENPELLI,ARNW,OENP01,149,0,0,149
WA,OSBORNE PARK,DBLV,OEPK02,0,0,213,213
VIC,OFFICER,OFFI,OFFI01,146,0,0,146
QLD,OAKEY,OKEY,OKEY01,621,0,0,621
QLD,OAKEY FLATS,OKFL,OKFL01,2622,0,0,2622
VIC,OAKLEIGH CHADSTONE SHOP,OAKL,OKLM01,158,0,0,158
NSW,OAKLANDS,OKLS,OKLS01,0,55,0,55
NSW,OAKWOOD,OKWD,OKWD01,0,0,0,0
VIC,OLINDA,OLIN,OLIN01,157,0,282,439
VIC,OMEO,OMEO,OMEO01,0,64,0,64
WA,ONSLOW,ONSL,ONSL01,70,0,0,70
SA,ONE TREE HILL,ONTH,ONTH01,129,0,0,129
NSW,OPHIR,OPHR,OPHR01,0,0,0,0
VIC,ORBOST,ORBO,ORBO01,68,0,0,68
QLD,ORMESBY,ORBY,ORBY01,129,0,0,129
NSW,ORANGE,ORGF,ORGF01,4000,0,0,4000
NSW,ORCHARD HILLS,ORHS,ORHS01,94,0,0,94
QLD,ORION,ORIO,ORIO01,0,0,24,24
VIC,ORMOND,ORMD,ORMD01,7,0,430,437
QLD,ORMEAU,ORME,ORME01,894,0,0,894
SA,ORROROO,OROO,OROO01,27,0,0,27
TAS,ORFORD,ORRD,ORRD01,281,0,0,281
SA,OSBORNE,OSBN,OSBN01,1503,0,451,1954
NSW,OURA,OURA,OURA01,0,0,0,0
TAS,OUSE,OUSE,OUSE01,169,0,0,169
VIC,OUTTRIM,OUTT,OUTT01,146,0,0,146
VIC,OUYEN,OUYN,OUYN01,41,0,0,41
QLD,OXENFORD,OXEN,OXEN01,1258,0,577,1835
NSW,OXLEY ISLAND,OXIS,OXIS01,0,94,0,94
QLD,OXENFORD PAC PINES OP MDF,OXEN,OXPT01,1767,0,0,1767
NSW,OXLEY VALE,OXVL,OXVL01,554,0,344,898
WA,OYSTER HARBOUR,OYHR,OYHR01,219,0,228,447
QLD,PAGET,PAGE,PAGE01,1688,0,0,1688
NSW,PALMERS ISLAND,PAIS,PAIS01,251,0,0,251
VIC,PAKENHAM UPPER,PAKU,PAKU01,2,102,0,104
QLD,PALLARENDA,PALL,PALL01,375,0,0,375
NSW,PALM BEACH,PALM,PALM01,962,0,0,962
NT,PALMERSTON,PALN,PALN01,3775,0,1518,5293
QLD,PALUMA,PALU,PALU01,0,0,0,0
NSW,PAMBULA,PAMB,PAMB01,34,0,67,101
TAS,PARNELLA,PANA,PANA01,192,0,0,192
VIC,PANMURE,PANM,PANM01,0,0,0,0
VIC,PANTON HILL,PANT,PANT01,19,0,0,19
WA,PANNAWONICA,PANW,PANW01,168,0,0,168
NT,TANAMI PAPUNYA,TNMI,PAPU01,65,0,0,65
QLD,PARKHURST,PARK,PARK01,971,0,227,1198
NSW,PARRAMATTA EXCHANGE,PARR,PARR01,8,0,0,8
VIC,PATCHEWOLLOCK,PATK,PATK01,161,0,0,161
QLD,PAWNGILLY,PAWN,PAWN01,132,0,0,132
VIC,PAYNESVILLE,PAYV,PAYV01,22,0,0,22
NSW,PATONGA BEACH,PBCH,PBCH01,235,0,0,235
SA,PORT BROUGHTON,PBRO,PBRO01,265,0,0,265
VIC,POINT COOK,PCOK,PCOK01,540,0,0,540
NSW,PICTON,PCTN,PCTN01,462,0,558,1020
WA,PARABURDOO,PDOO,PDOO01,62,0,0,62
QLD,PARADISE POINT,PDPT,PDPT01,345,0,1,346
QLD,PADDINGTON,PDTN,PDTN01,2,0,2049,2051
SA,PADTHAWAY,PDWY,PDWY01,141,0,0,141
QLD,PEACHESTER,PEAC,PEAC01,0,0,0,0
QLD,PEAK CROSSING,PEAG,PEAG01,170,0,0,170
NSW,PEAKHURST,PEAK,PEAK01,476,0,1086,1562
VIC,PEARCEDALE,PEAR,PEAR01,293,0,210,503
VIC,PETERBOROUGH,PEGH,PEGH01,185,0,0,185
TAS,PENGUIN,PEIN,PEIN01,528,84,0,612
SA,PENOLA,PELA,PELA01,213,0,0,213
NSW,PEMBROOKE,PEMB,PEMB01,0,49,0,49
NSW,PENDLE HILL,PEND,PEND01,87,0,8,95
NSW,PENNANT HILLS,PENN,PENN01,578,0,0,578
NSW,PENROSE,PENR,PENR01,183,0,0,183
VIC,PENSHURST,PENS,PENS01,0,115,0,115
TAS,PERTH,PERH,PERH01,814,0,0,814
NSW,PERTHVILLE,PERV,PERV01,238,0,14,252
TAS,PRIMROSE SANDS,PESS,PESS01,293,0,0,293
SA,PETERBOROUGH,PETB,PETB01,256,0,0,256
NSW,PETERSHAM,PETE,PETE01,228,0,2120,2348
QLD,PETRIE,PETR,PETR01,1608,0,0,1608
NT,DALY PALUMPA,DLLY,PFPA01,0,0,30,30
SA,PORT GERMEIN,PGER,PGER01,157,0,0,157
NT,DALY PEPPIMENARTI,DLLY,PGTI01,0,0,5,5
WA,PORT HEDLAND WEST,PHED,PHEC01,65,0,0,65
WA,PORT HEDLAND,PHED,PHED01,1,0,0,1
VIC,PIANGIL,PIAL,PIAL01,225,0,0,225
NSW,PIAMBONG,PIAM,PIAM01,0,0,15,15
WA,PICTON,PICT,PICT01,99,0,165,264
WA,PICTON DAVENPORT,PICT,PIDV01,230,0,0,230
WA,PIER,PIER,PIER01,779,0,0,779
QLD,PILTON,PILT,PILT01,0,0,0,0
WA,PINJARRA,PINJ,PINJ01,299,371,225,895
NT,PINE CREEK,PINK,PINK01,0,0,0,0
NSW,PIORA,PIOR,PIOR01,66,0,0,66
VIC,PIPERS CREEK,PIPK,PIPK01,0,0,33,33
SA,PORT PIRIE,PIRE,PIRE01,1533,0,387,1920
NSW,PITT TOWN,PITN,PITN01,95,0,0,95
NSW,PITT,PITT,PITT01,195,0,0,195
NT,PETERMANN JAMIESON,PETN,PJAS01,0,0,0,0
VIC,PAKENHAM,PKAM,PKAM01,4485,0,26,4511
QLD,PINKENBA,PKBA,PKBA01,365,0,0,365
WA,PICKERING BROOK,PKBK,PKBK01,165,0,0,165
NSW,PORT KEMBLA,PKEM,PKEM01,1453,648,1080,3181
NSW,PEAK HILL,PKHL,PKHL01,275,0,0,275
QLD,PARK RIDGE,PKRE,PKRE01,737,0,410,1147
NSW,PARKVILLE,PKVL,PKVL01,296,0,0,296
QLD,PIALBA,PLBA,PLBA01,0,0,0,0
NSW,PARKLEA,KELL,PLEA01,1539,0,0,1539
NT,PALMERSTON OMDF BUTLER PL,PALN,PLMK01,313,0,0,313
NSW,PACIFIC PALMS,PLMS,PLMS01,0,0,0,0
NSW,PORTLAND,PLND,PLND01,29,0,0,29
NT,PLENTY T001,PLNY,PLNU01,0,0,0,0
QLD,POINT LOOKOUT,PLOT,PLOT01,0,0,0,0
VIC,POWELLTOWN,PLTN,PLTN01,290,0,26,316
NSW,PALLAMALLAWA,PLWA,PLWA01,0,0,0,0
WA,PEMBERTON,PMBT,PMBT01,51,0,0,51
QLD,PALM CREEK,PMCK,PMCK01,0,0,0,0
VIC,PORT MELBOURNE,PMEL,PMEL01,113,0,2029,2142
QLD,PALM ISLAND,PMID,PMID01,323,0,0,323
NT,PALMERSTON FAIRWAY WATERS,PALN,PMTN01,737,0,0,737
QLD,PALMVIEW,PMVW,PMVW01,20,0,0,20
QLD,PALMWOODS,PMWS,PMWS01,433,148,201,782
WA,PALMYRA,PMYA,PMYA01,318,0,0,318
WA,PINGELLY,PNGL,PNGL01,0,0,0,0
SA,PINNAROO,PNRO,PNRO01,24,0,0,24
SA,PENNESHAW,PNSW,PNSW01,0,69,0,69
NSW,PENRITH,PNTH,PNTH01,320,0,0,320
VIC,PORT CAMPBELL,POCA,POCA01,342,0,0,342
VIC,PORT FAIRY,POFI,POFI01,354,0,0,354
NSW,POKOLBIN,POKO,POKO01,208,0,204,412
QLD,POMONA,POMA,POMA01,448,0,0,448
VIC,POMONAL,POMO,POMO01,0,0,0,0
TAS,POATINA,PONA,PONA01,184,0,0,184
VIC,POOWONG,POOW,POOW01,216,0,0,216
VIC,PORTLAND,PORD,PORD01,1528,0,146,1674
VIC,POREPUNKAH,PPKH,PPKH01,51,0,0,51
QLD,PROSERPINE,PPNE,PPNE01,1103,0,0,1103
NT,PETERMANN PIPALYATJARA,PETN,PPYT01,0,0,0,0
NSW,PERRICOOTA,PRCA,PRCA01,0,0,0,0
TAS,PROSPECT,PRCT,PRCT01,987,0,0,987
SA,PARNDANA,PRDA,PRDA01,0,84,0,84
SA,PARADISE,PRDS,PRDS01,960,0,447,1407
VIC,PIRIES,PRES,PRES01,156,0,0,156
SA,PARINGA,PRGA,PRGA01,281,0,0,281
QLD,PEREGIAN BEACH,PRGN,PRGN01,853,0,4,857
NSW,PARKES,PRKS,PRKS01,1346,0,327,1673
WA,PERENJORI,PRNJ,PRNJ01,120,0,0,120
TAS,PRESTON,PRON,PRON01,141,0,0,141
QLD,PROSTON,PROS,PROS01,129,0,0,129
SA,PROSPECT,PROT,PROT01,1796,0,0,1796
VIC,PRESTON,PRTN,PRTN01,562,0,0,562
WA,PINGRUP,PRUP,PRUP01,176,0,0,176
NSW,PERISHER VALLEY,PRVJ,PRVJ01,128,0,0,128
NSW,PATERSON,PSON,PSON01,23,0,0,23
SA,PORT AUGUSTA,PTAA,PTAA01,2557,0,0,2557
SA,PORT ADELAIDE,PTAD,PTAD01,775,0,713,1488
QLD,PORT DOUGLAS,PTDS,PTDS01,476,0,0,476
SA,PORT ELLIOT,PTET,PTET01,682,0,0,682
SA,PORT LINCOLN,PTLN,PTLN01,1225,0,193,1418
NSW,PORT MACQUARIE,PTMA,PTMA01,2195,0,4,2199
SA,PORT MACDONNELL,PTML,PTML01,249,0,0,249
VIC,PORTARLINGTON,PTON,PTON01,900,0,130,1030
NSW,PEATS RIDGE,PTRG,PTRG01,166,0,0,166
TAS,PORT SORELL,PTSL,PTSL01,630,0,0,630
QLD,PORTSMITH,PTSM,PTSM01,0,563,290,853
VIC,PUCKAPUNYAL,PUCK,PUCK01,93,0,0,93
WA,THE PENINSULA,VICP,PULA01,0,0,0,0
QLD,PURGA,PURG,PURG01,90,0,0,90
VIC,PURNIM,PURN,PURN01,0,0,0,0
SA,PORT VICTORIA,PVIC,PVIC01,150,0,0,150
WA,PARKERVILLE,PVIL,PVIL01,141,0,0,141
SA,PORT VINCENT,PVIN,PVIN01,77,0,0,77
QLD,BUFFLE VILLAGE,MNBH,PVKK01,0,0,24,24
SA,PORT WAKEFIELD,PWAK,PWAK01,121,0,0,121
NSW,PIALLAWAY,PWAY,PWAY01,0,0,0,0
QLD,CAVAL RIDGE,MNBH,PWKK01,0,0,24,24
QLD,PITTSWORTH,PWTH,PWTH01,525,0,0,525
NT,PETERMANN WANARN,PETN,PXAW01,0,0,0,0
NSW,PAXTON,PXTN,PXTN01,80,0,0,80
VIC,PYALONG,PYAL,PYAL01,145,0,0,145
NSW,PYMBLE,PYMB,PYMB01,187,0,0,187
VIC,PYRAMID HILL,PYRA,PYRA01,315,0,0,315
NSW,QUAAMA,QAMA,QAMA01,270,0,0,270
NSW,QUORROBOLONG,QBLG,QBLG01,0,27,0,27
WA,QUINNS ROCKS,QINS,QINS01,1659,0,425,2084
NSW,QUEANBEYAN,QNBN,QNBN01,3144,0,339,3483
NSW,QUANDIALLA,QNDL,QNDL01,157,0,0,157
WA,QUAIRADING,QUAI,QUAI01,217,0,0,217
NSW,QUAKERS HILL,QUAK,QUAK01,708,0,0,708
VIC,QUAMBATOOK,QUAM,QUAM01,136,0,0,136
QLD,QUEENS BEACH,QUEE,QUEE01,457,0,0,457
VIC,QUEENSCLIFF,QUEN,QUEN01,1077,0,421,1498
QLD,QUILPIE,QUIL,QUIL01,190,0,0,190
NSW,QUIRINDI,QUIR,QUIR01,227,0,0,227
SA,QUORN,QURN,QURN01,205,0,0,205
TAS,QUEENSTOWN,QUWN,QUWN01,0,0,0,0
QLD,RAINBOW BEACH,RABH,RABH01,100,0,0,100
VIC,RAINBOW,RAIN,RAIN01,0,88,0,88
NT,RAMINGINING,RAMI,RAMI01,169,0,0,169
NSW,RAMSGATE,RAMS,RAMS01,524,0,0,524
NSW,RANDWICK,RAND,RAND01,4,0,2027,2031
TAS,RAILTON,RAON,RAON01,83,0,0,83
NSW,RAVENSWORTH,RAVE,RAVE01,0,0,0,0
VIC,RAYWOOD,RAYD,RAYD01,130,0,0,130
QLD,ROBINA,RBNA,RBNA01,535,0,418,953
WA,ROEBOURNE,RBRN,RBRN01,66,0,0,66
SA,ROXBY DOWNS,RBYX,RBYX01,518,0,0,518
NSW,RICHMOND,RCHD,RCHD01,76,0,0,76
NSW,ROCKLEY,RCKY,RCKY01,144,0,0,144
VIC,RICHMOND,RCMD,RCMD01,407,0,50,457
VIC,RED HILL,RDHL,RDHL01,166,0,0,166
VIC,ROSEDALE,RDLE,RDLE01,123,0,0,123
QLD,REDLYNCH,RDLH,RDLH01,1436,0,585,2021
QLD,RATHDOWNEY,RDNY,RDNY01,0,0,0,0
QLD,REDBANK PLAINS,RDPS,RDPS01,1097,0,467,1564
NSW,REIDSDALE,RDSD,RDSD01,0,0,18,18
QLD,REDCLIFFE,REDC,REDC01,3104,0,0,3104
NSW,REDFERN,REDF,REDF01,1068,0,0,1068
QLD,REDLAND BAY,REDL,REDL01,2353,0,351,2704
QLD,REDRIDGE,REDR,REDR01,153,0,0,153
VIC,RED CLIFFS,REFS,REFS01,551,0,432,983
SA,REYNELLA,RELA,RELA01,3628,0,0,3628
VIC,RESEARCH,RESH,RESH01,2,0,189,191
NSW,REVESBY,REVE,REVE01,666,0,0,666
NSW,REGENTVILLE,REVL,REVL01,542,0,0,542
NSW,RAGLAN,RGAN,RGAN01,236,0,0,236
VIC,RUTHERGLEN,RGLN,RGLN01,424,0,0,424
QLD,RIDGEWOOD,RGWD,RGWD01,86,0,0,86
QLD,RAVENSHOE,RHOE,RHOE01,0,0,0,0
VIC,RHYLL,RHYL,RHYL01,300,0,0,300
QLD,RICHMOND,RICH,RICH01,185,0,0,185
TAS,RIVERSIDE,RIDE,RIDE01,357,0,0,357
VIC,RIDDELLS CREEK,RIDL,RIDL01,0,0,0,0
TAS,RIDGLEY,RIEY,RIEY01,106,0,0,106
TAS,RINGAROOMA,RIMA,RIMA01,208,0,0,208
TAS,RIANA,RINA,RINA01,109,0,0,109
TAS,RICHMOND,RIND,RIND01,238,0,0,238
VIC,RIPPLEBROOK,RIPP,RIPP01,143,0,0,143
NSW,RIVERSTONE,RIVE,RIVE01,155,0,0,155
WA,RIVERTON,RIVT,RIVT01,464,0,10,474
VIC,ROCKBANK,RKBK,RKBK01,0,0,0,0
WA,ROCKINGHAM,RKHM,RKHM01,3900,0,2596,6496
NSW,RALEIGH,RLGH,RLGH01,24,0,0,24
WA,ROLLING GREEN,RLGN,RLGN01,43,0,0,43
QLD,ROLLINGSTONE,RLSE,RLSE01,141,0,0,141
SA,RENMARK,RNKK,RNKK01,0,0,117,117
SA,RENMARK NORTH,RNKN,RNKN01,319,0,0,319
SA,RENMARK WEST,RNKK,RNKW01,232,0,0,232
QLD,ROADVALE,ROAD,ROAD01,100,0,0,100
SA,ROBE,ROBE,ROBE01,0,200,0,200
NSW,ROBERTSON,ROBN,ROBN01,96,0,0,96
VIC,ROCHESTER,ROCH,ROCH01,503,0,0,503
NSW,ROCKDALE,ROCK,ROCK01,719,0,0,719
NSW,THE ROCK,ROCT,ROCT01,0,213,0,213
VIC,ROKEWOOD,ROKE,ROKE01,0,0,0,0
VIC,ROKEBY,ROKY,ROKY01,209,0,0,209
VIC,ROBINVALE,ROLE,ROLE01,269,0,0,269
NSW,ROLLANDS PLAINS,ROLP,ROLP01,0,0,0,0
WA,ROLEYSTONE,ROLY,ROLY01,399,0,822,1221
QLD,ROMA,ROMA,ROMA01,436,0,139,575
VIC,ROMSEY,ROMS,ROMS01,344,0,320,664
TAS,ROMAINE,RONE,RONE01,469,0,0,469
NSW,ROOTY HILL,ROOT,ROOT01,419,0,0,419
QLD,ROLLESTON XSTRATA MINE,ROLL,ROQJ01,0,0,11,11
TAS,ROSEBERY,RORY,RORY01,0,0,0,0
VIC,ROSEBUD,ROSB,ROSB01,613,0,80,693
NSW,ROSEWOOD,ROSD,ROSD01,154,0,0,154
NSW,ROSE BAY,ROSE,ROSE01,1,0,1349,1350
TAS,ROSS,ROSS,ROSS01,170,0,0,170
NSW,ROUSE HILL,ROUS,ROUS01,0,0,199,199
VIC,ROWVILLE,ROWV,ROWV01,313,0,0,313
NT,ROPER RIVER BESWICK CMTS,ROPR,RQWP01,0,0,20,20
NSW,ROSEBANK,RSBK,RSBK01,123,0,0,123
SA,ROSEDALE,RSDE,RSDE01,119,0,0,119
QLD,ROSELLA,RSLA,RSLA01,325,0,0,325
QLD,ROSEDALE,RSLE,RSLE01,146,0,0,146
VIC,RESERVOIR,RSVR,RSVR01,80,0,0,80
QLD,ROSEWOOD,RSWD,RSWD01,469,0,370,839
SA,ROSEWORTHY,RSWY,RSWY01,124,0,0,124
NSW,RAYMOND TERRACE,RTCE,RTCE01,1505,0,457,1962
QLD,ROCKHAMPTON,RTON,RTON01,3840,0,0,3840
QLD,ROTHWELL,RTWL,RTWL01,1169,0,3,1172
VIC,RUPANYUP,RUPA,RUPA01,0,73,28,101
QLD,RUSSELL ISLAND,RUST,RUST01,3,0,0,3
NSW,RUTHERFORD,RUTH,RUTH01,2763,267,0,3030
VIC,RUSHWORTH,RUWH,RUWH01,183,0,0,183
QLD,RIVER HEADS,RVHS,RVHS01,0,0,0,0
WA,RAVENSTHORPE,RVNS,RVNS01,221,0,0,221
SA,RIVERTON,RVTN,RVTN01,109,0,0,109
VIC,RINGWOOD,RWOD,RWOD01,66,0,2659,2725
TAS,ROCKY CAPE,RYCE,RYCE01,134,0,0,134
NSW,RYDALMERE,RYDA,RYDA01,1,0,0,1
NSW,RYDE,RYDE,RYDE01,224,0,2210,2434
VIC,RYE,RYEE,RYEE01,2119,0,681,2800
NSW,RYLSTONE,RYLS,RYLS01,0,0,0,0
NSW,RAZORBACK,RZBK,RZBK01,0,125,0,125
TAS,SASSAFRAS,SAAS,SAAS01,0,0,0,0
TAS,SANDY BAY,SABY,SABY01,1143,0,471,1614
VIC,SAFETY BEACH,SAFH,SAFH01,185,75,255,515
SA,SALISBURY,SALA,SALA01,159,0,0,159
VIC,ST ALBANS,SALB,SALB01,374,0,2101,2475
VIC,SALE,SALE,SALE01,1208,0,620,1828
QLD,SANCTUARY COVE,SANC,SANC01,0,277,0,277
NSW,SANCTUARY POINT,SANP,SANP01,3,0,4,7
VIC,SAN REMO,SANR,SANR01,267,82,185,534
QLD,SAMFORD,SAOD,SAOD01,280,0,0,280
QLD,SARINA,SARI,SARI01,767,0,0,767
NSW,SALT ASH,SASH,SASH01,79,0,0,79
NT,SANTA TERESA COMMUNITY,RODG,SATA01,94,0,0,94
NSW,SAWTELL,SATL,SATL01,303,0,0,303
SA,STRATHALBYN,SBYN,SBYN01,1070,0,364,1434
VIC,SCARSDALE,SCAR,SCAR01,255,0,0,255
VIC,SARSFIELD,SCAS,SCAS01,0,242,0,242
WA,SCARBOROUGH,SCBH,SCBH01,248,0,423,671
TAS,SCAMANDER,SCER,SCER01,60,0,0,60
NSW,SCOTTS HEAD,SCHD,SCHD01,3,0,0,3
TAS,SCOTTSDALE,SCLE,SCLE01,293,0,0,293
ACT,SCULLIN,SCLN,SCLN01,199,0,2153,2352
NSW,SCONE,SCON,SCON01,644,0,388,1032
VIC,SCORESBY,SCOY,SCOY01,42,0,521,563
WA,SOUTHERN CROSS,SCRM,SCRM01,123,0,0,123
NSW,SANDY HOLLOW,SDHW,SDHW01,0,0,0,0
QLD,SANDGATE,SDTE,SDTE01,954,0,0,954
SA,SADDLEWORTH,SDWH,SDWH01,60,0,0,60
VIC,SEAFORD,SEAF,SEAF01,654,0,0,654
NSW,SEAHAM,SEAM,SEAM01,0,0,0,0
QLD,SECOND BEACH,SEBH,SEBH01,0,0,0,0
WA,SECRET HARBOUR,SECH,SECH01,80,0,0,80
SA,SEDAN,SEDN,SEDN01,0,1,0,1
SA,SEAFORD,SEFD,SEFD01,103,0,7,110
VIC,SEAFORD NORTH,SEFN,SEFN01,37,0,154,191
NSW,SEFTON,SEFT,SEFT01,276,0,0,276
VIC,SEA LAKE,SELC,SELC01,99,0,0,99
NSW,SEELANDS,SELD,SELD01,122,0,0,122
SA,SEMAPHORE,SEMC,SEMC01,2529,0,0,2529
SA,SOUTHEND,SEND,SEND01,0,0,173,173
NSW,KINGSCLIFF SALT,KCLF,SEOG01,369,0,0,369
VIC,SERPENTINE,SERP,SERP01,0,0,0,0
TAS,SAVAGE RIVER,SERR,SERR01,0,0,30,30
VIC,STRATHMERTON,SERT,SERT01,278,0,0,278
WA,SERPENTINE,SETI,SETI01,56,0,0,56
QLD,SEVERNLEA,SEVA,SEVA01,144,0,0,144
NSW,SEVEN HILLS,SEVE,SEVE01,333,0,0,333
VIC,SEYMOUR,SEYM,SEYM01,321,0,287,608
VIC,SYDENHAM EXCHANGE NORTH HUT,SHAM,SFOT01,75,0,0,75
QLD,SEAFORTH,SFTH,SFTH01,0,0,0,0
QLD,SPRING HILL,SGHL,SGHL01,170,0,0,170
QLD,SPRINGFIELD,SGID,SGID01,266,0,0,266
SA,STIRLING NORTH,SGNH,SGNH01,307,0,0,307
NSW,SHALVEY,SHAL,SHAL01,454,0,0,454
VIC,SYDENHAM,SHAM,SHAM01,345,0,0,345
QLD,SHARON,SHAR,SHAR01,266,0,216,482
QLD,SOUTHBROOK,SHBK,SHBK01,0,0,0,0
QLD,SHUTE HARBOUR,SHBR,SHBR01,280,0,0,280
WA,SOUTH HEDLAND,SHED,SHED01,0,0,803,803
NSW,SHERWOOD,SHER,SHER01,140,0,0,140
QLD,SMITHFIELD,SHFD,SHFD01,623,0,328,951
NSW,SHOALHAVEN HEADS,SHHD,SHHD01,0,0,0,0
QLD,SHINFIELD,SHIN,SHIN01,78,0,0,78
TAS,SHEFFIELD,SHLD,SHLD01,510,0,0,510
NSW,SMITHS LAKE,SHLK,SHLK01,44,0,0,44
TAS,LAUNCESTON SOUTH,SHLN,SHLN01,4452,0,0,4452
VIC,SYDENHAM NEW,SHAM,SHOO01,123,0,0,123
VIC,SHOREHAM,SHOR,SHOR01,310,0,0,310
VIC,SHEPPARTON EAST,SHPE,SHPE01,294,0,0,294
VIC,SHEPPARTON,SHPN,SHPN01,3101,0,2639,5740
TAS,SOUTH ARM,SHRM,SHRM01,154,0,0,154
QLD,SILKWOOD,SILK,SILK01,0,109,0,109
VIC,SILVAN,SILN,SILN01,15,44,21,80
NSW,SILVERWATER,SILV,SILV01,322,0,0,322
NSW,SINGLETON,SING,SING01,1260,0,4,1264
QLD,BUDERIM SIPPY CREEK,BUDE,SIPQ01,1609,0,0,1609
TAS,SIDMOUTH,SITH,SITH01,265,0,0,265
QLD,SOUTH JOHNSTONE,SJOH,SJOH01,222,0,0,222
SA,STOKES BAY,SKBY,SKBY01,0,0,19,19
VIC,SKIPTON,SKIP,SKIP01,0,68,10,78
VIC,SKYE,KALG,SKYE01,0,11,0,11
QLD,SLACKS CREEK,SLAC,SLAC01,548,0,2154,2702
QLD,SLADE POINT,SLAD,SLAD01,1191,0,365,1556
SA,SELLICKS,SLKS,SLKS01,882,0,0,882
NSW,SOLDIERS POINT,SLPT,SLPT01,1190,150,0,1340
NSW,SOMERSBY,SMBY,SMBY01,451,0,0,451
VIC,SMEATON,SMEA,SMEA01,0,0,0,0
VIC,SOUTH MELBOURNE,SMEL,SMEL01,945,0,0,945
SA,SMITHFIELD,SMFD,SMFD01,277,0,1,278
NSW,SMITHTOWN,SMIT,SMIT01,282,0,0,282
TAS,SMITHTON,SMON,SMON01,0,739,282,1021
VIC,SOUTH MORANG,SMRN,SMRN01,0,0,554,554
SA,SUMMERTOWN,SMTN,SMTN01,82,0,483,565
WA,SOMERVILLE,KGLE,SMVL01,37,0,94,131
VIC,SNAKE VALLEY,SNAV,SNAV01,328,0,0,328
VIC,SANDRINGHAM,SNDM,SNDM01,570,0,0,570
NSW,SINGLETON HEIGHTS,SNHS,SNHS01,873,0,207,1080
VIC,STANLEY,SNLY,SNLY01,0,75,0,75
VIC,STANHOPE,SNPE,SNPE01,112,0,0,112
VIC,SWANPOOL,SNPL,SNPL01,0,55,0,55
SA,SWAN REACH,SNRH,SNRH01,169,0,0,169
TAS,SNUG,SNUG,SNUG01,201,0,0,201
VIC,SOUTH OAKLEIGH,SOAK,SOAK01,111,0,1974,2085
TAS,SOMERSET,SOET,SOET01,358,0,291,649
VIC,STRATHBOGIE,SOGI,SOGI01,117,0,0,117
TAS,SORELL,SOLL,SOLL01,324,545,425,1294
VIC,SOMERVILLE,SOME,SOME01,1287,0,0,1287
NSW,SOMERTON,SOMN,SOMN01,81,0,0,81
QLD,SOUTHPORT,SOPT,SOPT01,8,0,0,8
VIC,SORRENTO,SORR,SORR01,556,0,225,781
NSW,SOUTH WINDSOR,BKPK,SOWR01,297,0,0,297
VIC,SEASPRAY,SPAY,SPAY01,0,92,0,92
QLD,SPRINGBROOK,SPBK,SPBK01,158,0,0,158
NSW,SPENCER,SPCR,SPCR01,33,0,0,33
SA,SPALDING,SPDG,SPDG01,125,0,0,125
VIC,SPRING GULLY,BEND,SPGY01,766,0,327,1093
NSW,SPRING HILL,SPHL,SPHL01,334,0,0,334
QLD,STEPHENS,SPHS,SPHS01,326,0,679,1005
VIC,SPRINGHURST,SPHT,SPHT01,168,0,0,168
VIC,SPRINGVALE,SPLE,SPLE01,721,0,0,721
QLD,STRATHPINE,SPNE,SPNE01,3096,0,5,3101
TAS,SPRENT,SPNT,SPNT01,164,0,0,164
VIC,SEBASTOPOL,SPOL,SPOL01,233,0,398,631
TAS,SPREYTON,SPON,SPON01,705,0,0,705
WA,SPEARWOOD,SPRD,SPRD01,647,0,5,652
QLD,SPRINGSURE,SPRI,SPRI01,0,0,0,0
NSW,SPRINGSIDE,SPSD,SPSD01,73,0,0,73
WA,SOUTH PERTH,SPTH,SPTH01,1034,0,2,1036
NSW,SPRINGWOOD,SPWD,SPWD01,330,0,0,330
QLD,SPEEWAH,SPWH,SPWH01,0,0,0,0
QLD,SCARBOROUGH,SRBG,SRBG01,1218,0,1000,2218
NSW,SACKVILLE REACH,SRCH,SRCH01,70,0,0,70
NSW,SPRING RIDGE,SRID,SRID01,0,0,0,0
NSW,SARATOGA,SRTA,SRTA01,1485,0,0,1485
VIC,SOMERTON,SRTN,SRTN01,2097,0,698,2795
WA,GOSNELLS SOUTHERN RIVER,GOSN,SRVZ01,31,0,0,31
QLD,SHERWOOD,SRWD,SRWD01,0,0,0,0
QLD,SALISBURY,SSBY,SSBY01,558,0,0,558
NSW,SWANSEA,SSEA,SSEA01,645,0,0,645
NSW,SOUTH STRATHFIELD,SSTR,SSTR01,496,0,0,496
NSW,ST ALBANS,STAL,STAL01,78,0,0,78
TAS,STRAHAN,STAN,STAN01,0,0,0,0
VIC,ST ARNAUD,STAR,STAR01,52,0,0,52
VIC,ST ANDREWS,STAS,STAS01,105,0,0,105
SA,STREAKY BAY,STBY,STBY01,135,0,0,135
SA,SCOTT CREEK,STCK,STCK01,47,0,0,47
VIC,STAWELL,STEL,STEL01,0,0,329,329
TAS,STANLEY,STEY,STEY01,259,0,0,259
NSW,STRATFORD,STFD,STFD01,161,0,0,161
QLD,ST GEORGE,STGE,STGE01,118,0,0,118
NSW,SOUTH BANK,STHB,STHB01,133,0,0,133
QLD,STANTHORPE,STHE,STHE01,1,0,58,59
NSW,ST HELENS PARK,STHJ,STHJ01,1218,0,0,1218
TAS,ST HELENS,STHS,STHS01,616,0,0,616
SA,STIRLING,STIC,STIC01,608,0,381,989
TAS,ST JOHN,STJN,STJN01,278,0,0,278
VIC,ST JAMES,STJS,STJS01,0,0,0,0
VIC,ST KILDA,STKA,STKA01,0,0,0,0
NSW,STOCKTON,STKN,STKN01,702,0,273,975
QLD,ST LAWRENCE,STLA,STLA01,0,42,0,42
NSW,ST LEONARDS,STLE,STLE01,19,0,2149,2168
VIC,ST LEONARDS,STLS,STLS01,293,248,0,541
NSW,ST MARYS,STMA,STMA01,69,0,0,69
SA,ST MARYS,STMF,STMN01,1605,0,1492,3097
TAS,ST MARYS,STMS,STMS01,120,0,0,120
WA,STRATTON,MDLD,STNX02,320,0,105,425
NSW,STOCKINBINGAL,STOC,STOC01,0,0,0,0
NSW,STOKERS SIDING,STOK,STOK01,170,0,0,170
SA,ST PETERS,STPE,STPE01,487,0,1492,1979
VIC,STRATHFIELDSAYE,STRA,STRA01,543,0,350,893
VIC,STRATFORD,STRD,STRD01,420,0,0,420
NSW,STROUD,STRO,STRO01,244,0,0,244
SA,STANSBURY,STRY,STRY01,134,0,0,134
NSW,SUTTON,STTN,STTN01,54,0,0,54
NSW,STUARTS POINT,STUP,STUP01,224,0,0,224
VIC,STRATH VILLAGE,BEND,STVL01,908,0,394,1302
WA,SUBIACO,SUBT,SUBT01,159,0,64,223
TAS,SULPHUR CREEK,SUCK,SUCK01,181,0,0,181
VIC,SUNBURY,SUNB,SUNB01,3327,0,390,3717
VIC,SUNSHINE,SUNS,SUNS01,189,0,0,189
NSW,SUFFOLK PARK,SUPK,SUPK01,1,0,3,4
QLD,SURAT,SURA,SURA01,0,18,0,18
QLD,SURFERS PARADISE,SURF,SURF01,2,0,0,2
NSW,SUTHERLAND,SUTH,SUTH01,262,0,0,262
VIC,SUTTON GRANGE,SUTT,SUTT01,0,0,0,0
NSW,SUSSEX INLET,SUXI,SUXI01,565,0,0,565
QLD,SAMSONVALE,SVLE,SVLE01,12,0,0,12
VIC,SWAN REACH,SWAR,SWAR01,111,0,0,111
QLD,SWANBANK,SWBK,SWBK01,179,0,501,680
VIC,SWIFTS CREEK,SWCK,SWCK01,167,0,0,167
TAS,SWANSEA,SWEA,SWEA01,249,0,0,249
VIC,SWAN HILL,SWIL,SWIL01,2099,0,343,2442
NSW,SOUTH WEST ROCKS,SWRS,SWRS01,25,0,306,331
NT,NOONAMAH STRANGWAYS,NNMH,SWYT01,86,0,0,86
QLD,SUNNYBANK,SYBK,SYBK01,376,0,7,383
NSW,SYLVANIA,SYLV,SYLV01,45,0,0,45
VIC,SANDY POINT,SYPT,SYPT01,0,50,0,50
VIC,SOUTH YARRA,SYRA,SYRA01,143,0,2148,2291
QLD,TARA,TAAR,TAAR01,179,0,0,179
QLD,TAYLORS BEACH,TABH,TABH01,164,0,0,164
NSW,TABLE TOP,TABL,TABL01,0,0,99,99
SA,TANUNDA,TADA,TADA01,609,0,0,609
TAS,TARGA,TAGA,TAGA01,0,0,0,0
VIC,TRARALGON,TAGN,TAGN01,2746,42,0,2788
NSW,TALBINGO,TALB,TALB01,0,0,0,0
VIC,TALBOT,TALT,TALT01,37,0,0,37
QLD,TALWOOD,TALW,TALW01,0,0,0,0
VIC,TAYLORS LAKES,SHAM,TALX02,59,0,0,59
VIC,TOOLAMBA,TAMA,TAMA01,335,0,0,335
QLD,TAMBO,TAMB,TAMB01,0,41,0,41
NSW,TAMWORTH,TAMH,TAMH01,618,0,0,618
WA,TAMMIN,TAMM,TAMM01,123,0,0,123
NSW,TAHMOOR,TAMR,TAMR01,1592,0,364,1956
NSW,TANJA,TANJ,TANJ01,95,0,0,95
VIC,TANJIL SOUTH,TANS,TANS01,0,0,0,0
TAS,TAROONA,TAOA,TAOA01,495,0,216,711
QLD,TAROOM,TAOM,TAOM01,215,0,0,215
NSW,TARCUTTA,TARC,TARC01,0,76,0,76
NSW,TAREE,TARE,TARE01,2704,0,43,2747
NSW,TAYLORS ARM,TARM,TARM01,117,0,0,117
NSW,TARANA,TARN,TARN01,0,0,0,0
NSW,TARRO,TARR,TARR01,1670,0,714,2384
VIC,TARRAVILLE,TARV,TARV01,0,0,0,0
WA,TARCOOLA,GLTN,TARX01,1128,0,0,1128
NSW,TATHRA,TATH,TATH01,81,0,0,81
VIC,TATURA,TATU,TATU01,166,0,0,166
QLD,TIN CAN BAY,TBAY,TBAY01,24,0,0,24
NSW,TULLIBIGEAL,TBGL,TBGL01,163,0,0,163
NSW,TABULAM,TBLM,TBLM01,128,0,0,128
QLD,TAMBORINE VILLAGE,TBNE,TBNE01,176,0,0,176
QLD,TAMBORINE MOUNTAIN,TBNM,TBNM01,4,0,312,316
NSW,TIMBUMBURI,TBRI,TBRI01,0,0,0,0
NSW,ARMIDALE DA047 TILBUSTER,ADLE,TBSR01,0,0,70,70
QLD,TOORBUL,TBUL,TBUL01,265,0,0,265
WA,TAMBELLUP,TBUP,TBUP01,164,0,0,164
NSW,TUCABIA,TCBA,TCBA01,0,119,0,119
NSW,TICHBORNE,TCNE,TCNE01,0,0,0,0
NSW,TWEED HEADS,TDHS,TDHS01,2537,0,0,2537
NSW,TWEED HEADS WEST,TDHW,TDHW01,114,0,111,225
VIC,TOORADIN,TDIN,TDIN01,64,0,0,64
NSW,TRUNDLE,TDLE,TDLE01,0,0,0,0
NSW,TERRANORA LODGE,TEEE,TEEE01,0,0,271,271
VIC,TEESDALE,TEES,TEES01,11,2,0,13
QLD,TE KOWAI,TEKO,TEKO01,160,0,0,160
NSW,TEMORA,TEMA,TEMA01,323,0,10,333
WA,TENTERDEN,TENT,TENT01,0,0,41,41
VIC,TERANG,TERA,TERA01,300,0,0,300
QLD,TIERI,TERI,TERI01,433,0,0,433
NSW,TERREY HILLS,TERR,TERR01,26,0,672,698
QLD,TEXAS,TEXA,TEXA01,0,0,0,0
NSW,TEA GARDENS TALL PINES,TGNS,TFWS01,0,0,23,23
VIC,TOONGABBIE,GARY,TGBY01,330,0,0,330
NSW,TINGHA,TGHA,TGHA01,0,104,0,104
VIC,TONGALA,TGLA,TGLA01,251,0,0,251
VIC,TUNGAMAH,TGMH,TGMH01,0,0,0,0
NSW,THARBOGANG,TGNG,TGNG01,150,0,0,150
NSW,TEA GARDENS,TGNS,TGNS01,2,0,34,36
QLD,THANGOOL,TGOL,TGOL01,308,0,0,308
QLD,TINGALPA,TGPA,TGPA01,360,0,0,360
QLD,TALLEBUDGERA,TGRA,TGRA01,420,0,0,420
VIC,TAGGERTY,TGTY,TGTY01,162,0,0,162
QLD,TUGUN,TGUN,TGUN01,101,0,161,262
VIC,THE GURDIES,TGUR,TGUR01,230,0,0,230
NSW,TOTTENHAM,THAM,THAM01,0,0,0,0
QLD,THARGOMINDAH,THAR,THAR01,0,63,0,63
NSW,THREDBO VILLAGE,THBO,THBO01,61,0,0,61
QLD,THE CAVES,THCS,THCS01,0,154,0,154
QLD,THEODORE,THEO,THEO01,234,0,0,234
QLD,THE SUMMIT,THES,THES01,0,122,0,122
NSW,THURGOONA,THGA,THGA01,861,0,175,1036
QLD,THE GAP,THGP,THGP01,149,0,0,149
NSW,THIRROUL,THIR,THIR01,3011,0,0,3011
VIC,THOONA,THNA,THNA01,166,0,0,166
QLD,THORNLANDS,THOR,THOR01,424,0,0,424
NSW,TELEGRAPH POINT,THPT,THPT01,277,0,0,277
WA,THREE SPRINGS,THSP,THSP01,98,0,0,98
VIC,THOMASTOWN,THTN,THTN01,70,0,434,504
VIC,TALLY HO TECH PARK,TYHO,THTP02,0,0,24,24
QLD,THURSDAY ISLAND,THUR,THUR01,59,0,0,59
ACT,THARWA,THWR,THWR01,0,0,0,0
QLD,TIARO,TIAR,TIAR01,279,0,0,279
NSW,TILBA TILBA,TILT,TILT01,45,0,0,45
VIC,TIMBOON,TIMB,TIMB01,110,0,0,110
NT,TIMBER CREEK,VIER,TIMP01,84,0,0,84
NSW,TINONEE,TINO,TINO01,279,0,0,279
NSW,TINTENBAR,TINT,TINT01,379,0,0,379
SA,TINTINARA,TIRA,TIRA01,339,0,0,339
NT,TIWI NGUIU,TIWI,TIWI01,0,0,0,0
NSW,TOUKLEY,TKLY,TKLY01,2242,0,0,2242
NSW,TARALGA,TLGA,TLGA01,0,0,74,74
NSW,TALLONG,TLNG,TLNG01,0,0,0,0
VIC,TALLANGATTA,TLTA,TLTA01,63,0,0,63
SA,TAILEM BEND,TMBD,TMBD01,240,0,0,240
NSW,TOMAGO,TMGO,TMGO01,0,60,88,148
VIC,TOLMIE,TMIE,TMIE01,126,0,0,126
VIC,TULLAMARINE,TMNE,TMNE01,1660,0,0,1660
VIC,TEMPLESTOWE,TMWE,TMWE01,408,0,0,408
NSW,TANILBA,TNBA,TNBA01,1,0,295,296
NSW,TURNBULL,TNBL,TNBL01,61,0,0,61
VIC,THORNBURY,TNBY,TNBY01,0,0,0,0
NSW,TYRINGHAM,TNHM,TNHM01,171,0,0,171
VIC,TARNEIT,TNIT,TNIT01,679,0,100,779
VIC,TARWIN LOWER,TNLR,TNLR01,108,0,0,108
QLD,TOWNSVILLE,TNSF,TNSF01,3446,0,53,3499
VIC,THORNTON,TNTN,TNTN01,0,99,0,99
NSW,TENNYSON,TNYN,TNYN01,36,0,0,36
QLD,TOOWOOMBA,TOBF,TOBF01,2096,0,0,2096
VIC,TOOLANGI,TOGI,TOGI01,202,0,0,202
QLD,TOOGOOM,TOGM,TOGM01,0,0,0,0
VIC,TOOLERN VALE,TOLE,TOLE01,28,0,0,28
QLD,TOLGA,TOLG,TOLG01,528,0,0,528
NSW,TOMERONG,TOME,TOME01,9,0,0,9
WA,TOODYAY,TOOD,TOOD01,272,0,0,272
VIC,TOORA,TOOR,TOOR01,285,0,0,285
VIC,TOPIRAM,TOPI,TOPI01,166,0,0,166
NSW,THORA,TORA,TORA01,0,0,0,0
VIC,TOORLOO ARM,TORM,TORM01,53,0,0,53
VIC,TORQUAY,TORQ,TORQ01,2277,11,851,3139
NSW,TABOURIE LAKE,TOUB,TOUB01,237,0,0,237
NSW,TOWRANG,TOWR,TOWR01,0,0,7,7
SA,TWO WELLS,TOWS,TOWS01,256,0,0,256
WA,TOM PRICE,TPCE,TPCE01,194,0,0,194
VIC,THORPDALE,TPDE,TPDE01,110,0,0,110
SA,TARPEENA,TPNA,TPNA01,0,0,0,0
WA,TAPPING,WANO,TPPF01,53,0,0,53
QLD,TORQUAY,TQAY,TQAY01,188,0,0,188
VIC,TRAFALGAR,TRAF,TRAF01,763,0,0,763
VIC,TOORAK,TRAK,TRAK01,182,0,286,468
NSW,TRALEE,TRAL,TRAL01,1975,0,397,2372
VIC,TRARALGON SOUTH,TRAS,TRAS01,301,0,0,301
NSW,TUMBARUMBA,TRBA,TRBA01,211,0,0,211
QLD,TREBONNE,TREB,TREB01,127,0,0,127
NSW,TREGEAGLE,TREG,TREG01,280,0,0,280
VIC,TRENTHAM,TREN,TREN01,0,29,0,29
NSW,TRANGIE,TRGE,TRGE01,266,0,0,266
NSW,TERRIGAL,TRGL,TRGL01,3384,0,766,4150
NSW,TARAGO,TRGO,TRGO01,0,0,0,0
TAS,TRIABUNNA,TRIB,TRIB01,301,0,0,301
QLD,TRINITY BEACH,TRIN,TRIN01,2695,0,0,2695
WA,TWO ROCKS EXCHANGE,YANP,TRKS02,51,0,0,51
NSW,TORONTO,TRTO,TRTO01,725,0,337,1062
SA,TRURO,TRUO,TRUO01,125,0,0,125
NSW,TRANSIT HILL,TSHL,TSHL01,2414,0,385,2799
NT,TENNANT CREEK,TTCK,TTCK01,578,0,0,578
NSW,TENTERFIELD,TTFD,TTFD01,34,1,0,35
QLD,TENT HILL,TTHL,TTHL01,62,0,0,62
TAS,TULLAH,TUAH,TUAH01,118,0,0,118
QLD,TUCHEKOI,TUCH,TUCH01,138,0,0,138
ACT,TUGGERANONG,TUGG,TUGG01,181,0,0,181
NSW,TUROSS HEAD,TUHD,TUHD01,99,0,0,99
QLD,TULLY,TULF,TULF01,177,0,0,177
NSW,TUMBULGUM,TUMB,TUMB01,301,0,0,301
NSW,TUMUT,TUMU,TUMU01,893,0,396,1289
QLD,TUNGAMULL,TUNG,TUNG01,194,0,0,194
NSW,TURA BEACH,TURA,TURA01,0,0,166,166
NSW,TULLAMORE,TURE,TURE01,126,0,0,126
WA,TUART HILL,TUTT,TUTT01,0,0,0,0
QLD,TOOGOOLAWAH,TWAH,TWAH01,0,209,0,209
NSW,TOCUMWAL,TWAL,TWAL01,49,0,0,49
NSW,TOORAWEENAH,TWNH,TWNH01,0,0,0,0
QLD,TOOWONG,TWOG,TWOG01,1,0,43,44
VIC,TYABB,TYAB,TYAB01,326,0,374,700
NSW,TYALGUM,TYAL,TYAL01,0,321,0,321
QLD,TURKEY BEACH,TYBH,TYBH01,0,0,24,24
SA,TUMBY BAY,TYBY,TYBY01,316,0,0,316
VIC,TYERS EXCHANGE,TYER,TYER01,292,0,0,292
VIC,TALLYGAROOPNA,TYGA,TYGA01,0,0,141,141
VIC,TALLY HO,TYHO,TYHO01,768,0,0,768
VIC,TYLDEN,TYLD,TYLD01,0,107,0,107
VIC,TYRENDARRA,TYRN,TYRN01,0,0,0,0
NSW,UKI,UKII,UKII01,0,31,0,31
NSW,ULAN,ULAN,ULAN01,0,0,13,13
NSW,UPPER LANSDOWNE,ULDN,ULDN01,0,0,0,0
NSW,ULLADULLA,ULLA,ULLA01,1165,0,376,1541
TAS,ULVERSTONE,ULNE,ULNE01,1326,0,0,1326
NSW,ULONG,ULON,ULON01,161,0,0,161
VIC,ULTIMA,ULTA,ULTA01,0,25,0,25
NSW,ULMARRA,UMRA,UMRA01,284,0,0,284
NT,PETERMANN DA194 UMUWA,PETN,UMUW01,17,0,0,17
NSW,UNANDERRA,UNAN,UNAN01,2557,0,0,2557
NSW,UNDERCLIFFE,UNDE,UNDE01,53,0,525,578
VIC,UNDERBOOL,UNDL,UNDL01,0,66,0,66
VIC,UNDERA,UNDR,UNDR01,0,66,0,66
NSW,UNGARIE,UNGR,UNGR01,165,0,0,165
SA,UNLEY,UNLY,UNLY01,1299,0,0,1299
NSW,UPPER ORARA,UORA,UORA01,0,197,0,197
QLD,UPPER CABOOLTURE,UPCA,UPCA01,284,0,0,284
QLD,UPPER WIDGEE,UPWI,UPWI01,102,0,0,102
NSW,URANQUINTY,URAQ,URAQ01,220,0,0,220
NSW,URBENVILLE,URBE,URBE01,0,72,0,72
NSW,URUNGA,URGA,URGA01,171,0,0,171
NSW,URALLA,URLA,URLA01,0,0,83,83
NSW,URANA,URNA,URNA01,0,94,0,94
ACT,URIARRA FOREST,URRA,URRA01,188,0,0,188
NSW,VACY,VACY,VACY01,26,0,0,26
NSW,VALLA,VALA,VALA01,0,0,32,32
QLD,VICTORIA POINT,VAPT,VAPT01,102,0,107,209
VIC,VASEY,VASE,VASE01,0,0,0,0
WA,VASSE,VASS,VASS01,184,0,0,184
NSW,VAUCLUSE,VAUC,VAUC01,142,0,0,142
VIC,VENUS BAY,VENB,VENB01,270,0,0,270
QLD,VERESDALE,VERE,VERE01,386,0,184,570
WA,VICTORIA PARK,VICP,VICP01,1999,0,2301,4300
VIC,VIOLET TOWN,VIOL,VIOL01,258,0,0,258
QLD,VALLEY,VLLY,VLLY01,605,0,556,1161
NSW,VALENTINE,VLTN,VLTN01,367,0,0,367
VIC,VENTNOR,VNOR,VNOR01,220,0,0,220
SA,VIRGINIA,VRGA,VRGA01,203,0,0,203
SA,VICTOR HARBOR,VRHR,VRHR01,1368,0,644,2012
TAS,WARATAH,WAAH,WAAH01,0,0,152,152
VIC,WAAIA,WAAI,WAAI01,153,0,0,153
QLD,WANDOAN,WAAN,WAAN01,282,0,0,282
WA,WARNBRO,WABO,WABO01,576,0,202,778
VIC,WALLACE,WACE,WACE01,0,0,0,0
QLD,WACOL,WACL,WACL01,456,0,0,456
NT,DALY WADEYE,DLLY,WADE01,16,0,0,16
VIC,WANDIN,WADI,WADI01,205,0,0,205
NSW,WARDELL,WADL,WADL01,0,13,0,13
VIC,WANDONG,WADO,WADO01,71,0,0,71
TAS,WAVERLEY,WAEY,WAEY01,668,0,392,1060
NSW,WAGGA WAGGA,WAGA,WAGA01,1761,0,0,1761
NSW,WAHROONGA,WAHR,WAHR01,158,0,0,158
QLD,WALKAMIN,WAIN,WAIN01,0,108,0,108
NT,PETERMANN WARAKURNA,PETN,WAKU01,0,0,23,23
NSW,WALLA WALLA,WALA,WALA01,0,60,41,101
NSW,WALLERAWANG,WALG,WALG01,0,0,0,0
VIC,WALKERVILLE,WALK,WALK01,152,0,0,152
QLD,WALLANGARRA,WALL,WALL01,0,0,0,0
WA,WALPOLE,WALP,WALP01,0,67,0,67
QLD,WALLAVILLE,WALV,WALV01,142,0,0,142
QLD,WELLCAMP,WAMP,WAMP01,232,0,0,232
WA,WILLIAMS,WAMS,WAMS01,0,0,0,0
QLD,WAMURAN,WAMU,WAMU01,272,0,0,272
WA,WANDERING,WAND,WAND01,173,0,0,173
VIC,WANGARATTA,WANG,WANG01,2326,0,0,2326
WA,WANNEROO,WANO,WANO01,69,0,1000,1069
QLD,WALLOON,WAON,WAON01,333,0,0,333
VIC,WAURN PONDS,WAPD,WAPD01,133,0,0,133
VIC,WONGA PARK,WAPK,WAPK01,263,0,66,329
VIC,WARBURTON,WARB,WARB01,909,0,159,1068
QLD,WARWICK,WARW,WARW01,326,0,651,977
VIC,WAUBRA,WAUB,WAUB01,0,0,0,0
NSW,WAUCHOPE,WAUH,WAUH01,744,0,116,860
NSW,WAVERLEY,WAVE,WAVE01,269,0,0,269
SA,WAYMOUTH,WAYM,WAYM01,1074,0,0,1074
NSW,WALLABADAH,WBDH,WBDH01,0,0,0,0
VIC,WERRIBEE SOUTH,WBES,WBES01,152,0,0,152
NSW,WARRUMBUNGLE,WBLE,WBLE01,0,0,0,0
VIC,WARRNAMBOOL,WBOL,WBOL01,5166,0,0,5166
NSW,WONGARBON,WBON,WBON01,0,0,0,0
QLD,WESTBROOK,WBRK,WBRK01,0,0,178,178
NT,PETERMANN WARBURTON,PETN,WBRM01,0,0,1,1
QLD,WONDAI,WDAI,WDAI01,206,0,0,206
NSW,WOODENBONG,WDBG,WDBG01,306,0,0,306
NSW,WOODBURN,WDBN,WDBN01,0,89,0,89
VIC,WODONGA,WDGA,WDGA01,3058,0,380,3438
VIC,WODONGA WEST,WDGW,WDGW01,1926,135,0,2061
NSW,WESTDALE,WDLE,WDLE01,77,0,0,77
VIC,WOODEND,WDND,WDND01,467,0,0,467
SA,WOODSIDE,WDSE,WDSE01,236,0,2,238
VIC,WARRANDYTE,WDTE,WDTE01,585,0,0,585
SA,WOODVILLE,WDVL,WDVL01,518,0,0,518
ACT,WESTON CREEK,WECK,WECK01,1374,0,0,1374
VIC,WEDDERBURN,WEDN,WEDN01,12,0,0,12
WA,KELMSCOTT WESTFIELD,KELM,WEFL01,526,0,0,526
NSW,WELLINGTON,WELL,WELL01,643,0,422,1065
VIC,WENDOUREE,WEND,WEND01,570,0,683,1253
QLD,WOLFFDENE,WENE,WENE01,122,0,0,122
NSW,WENTWORTH,WENH,WENH01,390,0,0,390
QLD,WEIPA,WEPD,WEPD01,74,0,0,74
QLD,WELLINGTON POINT,WEPN,WEPN01,135,0,0,135
VIC,WERRIBEE,WERE,WERE01,804,0,0,804
TAS,WESTBURY,WERY,WERY01,265,0,0,265
SA,WEST ADELAIDE,WESA,WESA01,0,0,279,279
VIC,WEST ESSENDON,WESS,WESS01,95,0,109,204
QLD,WESTWOOD,WEST,WEST01,0,0,0,0
NSW,WETHERILL PARK,WETH,WETH01,1867,0,0,1867
VIC,WALPEUP,WEUP,WEUP01,0,63,0,63
TAS,WEYMOUTH,WEYH,WEYH01,186,0,0,186
NSW,WENTWORTH FALLS,WFAL,WFAL01,1250,0,0,1250
NSW,WILBERFORCE,WFCE,WFCE01,0,0,1,1
NSW,WISEMANS FERRY,WFRY,WFRY01,169,0,0,169
NSW,WARRAGAMBA,WGBA,WGBA01,992,0,0,992
NSW,WAGGA EAST,WGEA,WGEA01,399,0,392,791
WA,WAGIN,WGIN,WGIN01,0,0,0,0
NT,PETERMANN WINGELLINA,PETN,WGLA01,0,0,0,0
NSW,WOOLGOOLGA,WGLG,WGLG01,68,0,0,68
VIC,WARRAGUL SOUTH,WGLS,WGLS01,136,0,0,136
NSW,WAGGA SOUTH,WGSO,WGSO01,1446,0,755,2201
NT,COX PENINSULA WAGAIT,CXPA,WGTT01,0,32,0,32
VIC,WARRAGUL,WGUL,WGUL01,1326,0,365,1691
VIC,EPPING,EPPG,WGXH01,82,0,0,82
NSW,WYNDHAM,WHAM,WHAM01,62,0,0,62
VIC,WHEELERS HILL AFL PARK,WHLL,WHEH01,5,0,196,201
SA,WHYALLA JENKINS,WHJS,WHJS01,767,136,0,903
SA,WHYALLA,WHLA,WHLA01,1486,314,0,1800
VIC,WHEELERS HILL,WHLL,WHLL01,474,0,0,474
NSW,WHITTON,WHTN,WHTN01,172,0,0,172
TAS,WINNALEAH,WIAH,WIAH01,130,0,0,130
WA,WITCHCLIFFE,WICH,WICH01,119,0,0,119
NSW,WIANGAREE,WIEE,WIEE01,140,0,0,140
SA,WILLUNGA,WIGA,WIGA01,0,541,230,771
WA,WICKHAM,WIKM,WIKM01,305,0,0,305
NSW,WILCANNIA,WILC,WILC01,0,0,22,22
NSW,WILLOUGHBY,WILL,WILL01,312,0,0,312
NSW,WILTON,WILT,WILT01,0,0,0,0
WA,WILUNA,WILU,WILU01,34,0,0,34
VIC,WINCHELSEA,WINC,WINC01,363,0,0,363
QLD,WOODBINE,WINE,WINE01,75,0,0,75
NSW,WINGHAM,WING,WING01,691,0,0,691
VIC,WINCHELSEA SOUTH,WINS,WINS01,155,0,0,155
QLD,WINTON,WINT,WINT01,111,0,0,111
TAS,WILMOT,WIOT,WIOT01,145,0,0,145
VIC,WINDSOR,WIRC,WIRC01,835,0,0,835
QLD,WITHCOTT,WITH,WITH01,296,0,0,296
QLD,WITTA,WITT,WITT01,101,0,0,101
VIC,WARRACKNABEAL,WKBL,WKBL01,192,0,0,192
QLD,WALKERSTON,WKON,WKON01,315,0,0,315
SA,WAIKERIE,WKRE,WKRE01,496,0,0,496
NSW,WYRALLAH,WLAH,WLAH01,284,0,0,284
VIC,WALLAN HIDDEN VALLEY,WLAN,WLAL01,176,0,213,389
VIC,WALLAN,WLAN,WLAN01,1337,183,25,1545
QLD,WOONGOOLBA,WLBA,WLBA01,236,0,10,246
NSW,WALLENDBEEN,WLBN,WLBN01,134,0,0,134
NSW,WARRELL CREEK,WLCK,WLCK01,328,0,0,328
NSW,WALCHA ROAD,WLCR,WLCR01,0,0,0,0
NSW,WALGETT,WLET,WLET01,178,52,131,361
NSW,WOLLONGONG,WLGG,WLGG01,4642,0,317,4959
QLD,WULGURU,WLGU,WLGU01,0,0,301,301
NSW,WALCHA,WLHA,WLHA01,0,0,0,0
QLD,WOOROOLIN,WLIN,WLIN01,144,0,0,144
SA,WILMINGTON,WLMG,WLMG01,52,0,0,52
VIC,WOOMELANG,WLNG,WLNG01,0,0,0,0
VIC,WILLAURA,WLRA,WLRA01,0,108,0,108
VIC,WOLLERT,WLRT,WLRT01,108,0,0,108
NSW,WALLSEND,WLSD,WLSD01,3625,0,0,3625
WA,WELLINGTON,WLTE,WLTE01,59,0,643,702
SA,WILLIAMSTOWN,WLTN,WLTN01,140,0,0,140
VIC,WALWA,WLWA,WLWA01,0,22,0,22
QLD,WILLOWS,WLWS,WLWS01,176,0,0,176
QLD,WALLUMBILLA,WMBA,WMBA01,0,0,0,0
NSW,WAMBOIN,WMBN,WMBN01,0,43,0,43
WA,WEMBLEY,WMBY,WMBY01,2,0,1984,1986
NSW,WILLIAMSDALE,WMLE,WMLE01,299,0,0,299
NSW,WARRIMOO,WMOO,WMOO01,194,0,0,194
SA,WOOMERA,WMRA,WMRA01,0,102,0,102
NSW,WILLIAMTOWN,WMTN,WMTN01,32,0,0,32
VIC,WARNEET,WNET,WNET01,155,0,0,155
NSW,WANGI WANGI,WNGI,WNGI01,0,0,0,0
WA,WONGAN HILLS,WNGN,WNGN01,235,0,0,235
VIC,WARRENHEIP,WNHP,WNHP01,0,367,0,367
SA,WINKIE,WNKE,WNKE01,144,0,0,144
NSW,WINMALEE,WNML,WNML01,318,0,0,318
WA,WANNEROO DA053,WANO,WNRK01,0,32,20,52
QLD,WINDAROO,WNRO,WNRO01,773,0,224,997
WA,WANNEROO CA009,WANO,WNUS01,90,0,312,402
QLD,WOOLLOONGABBA,WOBB,WOBB01,223,0,2176,2399
NSW,WOLLOMBI,WOBI,WOBI01,0,33,0,33
QLD,WOODSTOCK,WOCK,WOCK01,155,0,0,155
SA,WATERLOO CORNER,WOCR,WOCR01,3,0,0,3
VIC,WOODSIDE,WOID,WOID01,162,0,0,162
NSW,WOLFE,WOLF,WOLF01,2389,0,463,2852
NSW,WOOLI,WOLI,WOLI01,366,0,0,366
NSW,WOLUMLA,WOLU,WOLU01,186,0,0,186
QLD,WOLVI,WOLV,WOLV01,0,0,0,0
NSW,WOMBAT,WOMT,WOMT01,0,0,0,0
WA,WAROONA,WONA,WONA01,197,0,197,394
VIC,WONTHAGGI,WONE,WONE01,1098,0,449,1547
QLD,WONGA,WONG,WONG01,102,0,0,102
QLD,WOORABINDA,WOOB,WOOB01,0,0,0,0
QLD,WOODFORD,WOOD,WOOD01,186,0,0,186
QLD,WOONGARRA,WOON,WOON01,157,0,0,157
WA,WOOROLOO,WOOR,WOOR01,148,0,0,148
QLD,WOOMBYE,WOOY,WOOY01,259,0,340,599
VIC,WOORI YALLOCK,WORA,WORA01,770,0,401,1171
VIC,WOOLSTHORPE,WORP,WORP01,0,0,0,0
QLD,WOODGATE,WOTE,WOTE01,120,0,0,120
VIC,WILLOW GROVE,WOVE,WOVE01,0,20,0,20
QLD,WOWAN,WOWA,WOWA01,0,0,0,0
NSW,WOY WOY,WOYY,WOYY01,4360,0,242,4602
WA,WICKEPIN,WPIN,WPIN01,93,0,0,93
VIC,WELSHPOOL,WPOL,WPOL01,0,0,27,27
SA,WIRRABARA,WRAB,WRAB01,141,0,0,141
QLD,WINDORAH ,HADN,WRAH01,135,0,0,135
NSW,WALLAROBBA,WRBA,WRBA01,0,0,39,39
NSW,WEROMBI,WRBI,WRBI01,61,0,0,61
NSW,WARIALDA,WRDA,WRDA01,60,0,0,60
SA,WAROOKA,WRKA,WRKA01,159,0,0,159
NSW,WARILLA,WRLA,WRLA01,2768,0,1474,4242
VIC,WHOROULY,WRLY,WRLY01,123,0,0,123
VIC,WANTIRNA,WRNA,WRNA01,830,0,0,830
QLD,WARNER,WRNE,WRNE01,1769,0,747,2516
SA,WALLAROO,WROO,WROO01,197,0,0,197
NSW,WARILLA SHELL COVE OP MDF,WRLA,WRQB01,263,0,0,263
WA,WOORREE,GLTN,WRRE01,759,0,0,759
NSW,WARREN,WRRN,WRRN01,138,0,0,138
VIC,WARRANWOOD,WRWD,WRWD01,589,0,0,589
NT,ARNHEM WEST WARRUWI,ARNW,WRWI01,134,0,0,134
NSW,WESTBROOK,WSBK,WSBK01,132,0,0,132
NSW,WERRIS CREEK,WSCK,WSCK01,46,0,0,46
VIC,WHITTLESEA,WSEA,WSEA01,525,243,434,1202
SA,WISANGER,WSGR,WSGR01,0,0,0,0
NSW,WINDSOR,WSOR,WSOR01,969,0,0,969
NSW,WAGSTAFF POINT,WSTF,WSTF01,358,0,393,751
NSW,WOODSTOCK,WSTK,WSTK01,143,0,0,143
NSW,WEST TAMWORTH,WTAM,WTAM01,176,0,1008,1184
QLD,WATERFORD,WTFD,WTFD01,38,0,436,474
NSW,WEETHALLE,WTLE,WTLE01,0,95,0,95
VIC,WILLIAMSTOWN,WTON,WTON01,2160,0,735,2895
NSW,WILLOW TREE,WTRE,WTRE01,162,0,0,162
QLD,WHITE ROCK,WTRK,WTRK01,1622,0,666,2288
NSW,WEST WALLSEND,WTWD,WTWD01,1468,42,0,1510
SA,WUDINNA,WUDA,WUDA01,186,0,0,186
WA,WUNDOWIE,WUND,WUND01,57,0,0,57
QLD,WURTULLA,WURT,WURT01,3952,0,0,3952
SA,WATERVALE,WVLE,WVLE01,0,4,29,33
NSW,WEE WAA,WWAA,WWAA01,4,0,0,4
NSW,WETHERILL PARK WEST,WETH,WWPK01,596,0,11,607
NSW,WANDSWORTH,WWTH,WWTH01,0,0,0,0
NSW,WEST WYALONG,WWYL,WWYL01,355,0,0,355
NSW,WALLSEND MARYLAND MDF2,WLSD,WXND01,784,0,0,784
WA,WYALKATCHEM,WYAL,WYAL01,87,0,0,87
VIC,WYCHEPROOF,WYCF,WYCF01,257,0,0,257
NSW,WYEE,WYEE,WYEE01,301,0,0,301
VIC,WYE RIVER,WYER,WYER01,0,27,0,27
WA,WYNDHAM,WYNF,WYNF01,78,0,0,78
NSW,WYONG,WYNG,WYNG01,2679,0,0,2679
QLD,WYNNUM,WYNM,WYNM01,2,0,2050,2052
NSW,WYONG OP MDF TUGGERAH,WYNG,WYQQ01,272,0,0,272
TAS,WYNYARD,WYRD,WYRD01,1087,0,0,1087
QLD,WYREEMA,WYRE,WYRE01,296,0,0,296
TAS,WESLEY VALE,WYVE,WYVE01,159,0,0,159
VIC,YARRA GLEN,YAGN,YAGN01,591,0,0,591
VIC,YARRA JUNCTION,YAJN,YAJN01,854,0,0,854
VIC,YALCA,YALC,YALC01,174,0,0,174
WA,YALGOO,YALG,YALG01,67,0,0,67
VIC,YALLOURN NORTH,YALN,YALN01,268,0,0,268
QLD,YANDARAN,YAND,YAND01,138,0,0,138
WA,YANCHEP,YANP,YANP01,212,0,0,212
VIC,YANNATHAN,YANS,YANS01,157,0,0,157
QLD,YAKAPARI,YARI,YARI01,0,210,0,210
WA,YARLOOP,YARL,YARL01,331,0,0,331
VIC,YARRAGON,YARN,YARN01,54,0,0,54
QLD,YARWUN,YARW,YARW01,0,138,0,138
NSW,YASS,YASS,YASS01,872,0,358,1230
QLD,YANDARAN REMOTE MDF,YAND,YAXY01,91,0,0,91
NSW,YATTEYATTAH,YAYA,YAYA01,204,0,0,204
QLD,YARRABAH,YBAH,YBAH01,41,0,0,41
QLD,YABULU,YBLU,YBLU01,456,0,0,456
VIC,YEA,YEAA,YEAA01,208,0,0,208
QLD,YULEBA,YEBA,YEBA01,0,0,0,0
QLD,YELARBON,YELA,YELA01,0,0,0,0
VIC,YENDON,YEND,YEND01,89,0,0,89
VIC,YEODENE,YEOD,YEOD01,0,38,0,38
QLD,YEPPOON,YEPP,YEPP01,1173,0,837,2010
NSW,YERONG CREEK,YERO,YERO01,0,0,0,0
VIC,YELLINGBO,YGBO,YGBO01,251,0,0,251
WA,YALLINGUP,YGUP,YGUP01,289,0,0,289
QLD,YANDINA,YINA,YINA01,0,0,59,59
VIC,YINNAR,YINN,YINN01,222,0,0,222
VIC,YINNAR SOUTH,YINS,YINS01,0,0,0,0
VIC,YACKANDANDAH,YKDH,YKDH01,137,0,363,500
SA,YANKALILLA,YKLA,YKLA01,319,0,0,319
SA,NORMANVILLE,YKLA,YKLX01,0,369,0,369
WA,YALLINGUP SOUTH,YGUP,YLLX02,0,26,0,26
QLD,YARRAMAN,YMAN,YMAN01,0,188,0,188
NSW,YAMBA,YMBA,YMBA01,0,0,426,426
VIC,YARRAMBAT,YMBT,YMBT01,114,0,0,114
NSW,YANCO,YNCO,YNCO01,303,0,0,303
NSW,YENDA,YNDA,YNDA01,0,326,0,326
QLD,YORKEYS KNOB,YNOB,YNOB01,499,71,0,570
VIC,YANDOIT,YOIT,YOIT01,0,0,0,0
TAS,YOLLA,YOLA,YOLA01,141,0,0,141
NSW,YOUNG,YONG,YONG01,1166,0,768,1934
NSW,YERRINBOOL,YOOL,YOOL01,86,0,0,86
WA,YORK,YORS,YORS01,0,0,273,273
SA,YORKETOWN,YOWN,YOWN01,278,0,0,278
VIC,YARRAM,YRAM,YRAM01,173,0,0,173
QLD,YERONGA,YRGA,YRGA01,0,0,0,0
NSW,YARRAMALONG,YRMG,YRMG01,156,0,0,156
NT,YUENDUMU,YUEN,YUEN01,0,60,0,60
NT,YULARA,YULA,YULA01,171,0,0,171
WA,YUNDERUP,YUND,YUND01,16,0,0,16
QLD,YUNGABURRA,YUNG,YUNG01,420,0,0,420
NSW,YEOVAL,YVAL,YVAL01,0,0,0,0
VIC,YARRAWONGA,YWGA,YWGA01,276,0,22,298
VIC,YARROWEYAH,YYAH,YYAH01,271,0,0,271
TAS,ZEEHAN,ZEAN,ZEAN01,0,0,0,0
QLD,ZILLMERE,ZMRE,ZMRE01,852,0,0,852